,tconst,primary_title,runtime_minutes,genres,release_date,production_budget,domestic_gross,worldwide_gross,total_profit
0,tt1775309,Avatar,93.0,"Action,Adventure,Fantasy","Dec 18, 2009",425000000,760507625,2776345279,2351345279
2,tt4154756,Avengers: Infinity War,149.0,"Action,Adventure,Sci-Fi","Apr 27, 2018",300000000,678815482,2048134200,1748134200
3,tt0369610,Jurassic World,124.0,"Action,Adventure,Sci-Fi","Jun 12, 2015",215000000,652270625,1648854864,1433854864
4,tt2820852,Furious 7,137.0,"Action,Crime,Thriller","Apr 3, 2015",190000000,353007020,1518722794,1328722794
5,tt0848228,The Avengers,143.0,"Action,Adventure,Sci-Fi","May 4, 2012",225000000,623279547,1517935897,1292935897
6,tt1825683,Black Panther,134.0,"Action,Adventure,Sci-Fi","Feb 16, 2018",200000000,700059566,1348258224,1148258224
7,tt4881806,Jurassic World: Fallen Kingdom,128.0,"Action,Adventure,Sci-Fi","Jun 22, 2018",170000000,417719760,1305772799,1135772799
11,tt2395427,Avengers: Age of Ultron,141.0,"Action,Adventure,Sci-Fi","May 1, 2015",330600000,459005868,1403013963,1072413963
12,tt3606756,Incredibles 2,118.0,"Action,Adventure,Animation","Jun 15, 2018",200000000,608581744,1242520711,1042520711
13,tt1300854,Iron Man 3,130.0,"Action,Adventure,Sci-Fi","May 3, 2013",200000000,408992272,1215392272,1015392272
14,tt1477834,Aquaman,143.0,"Action,Adventure,Fantasy","Dec 21, 2018",160000000,335061807,1146894640,986894640
15,tt4630562,The Fate of the Furious,136.0,"Action,Crime,Thriller","Apr 14, 2017",250000000,225764765,1234846267,984846267
17,tt4154664,Captain Marvel,123.0,"Action,Adventure,Sci-Fi","Mar 8, 2019",175000000,426525952,1123061550,948061550
18,tt1399103,Transformers: Dark of the Moon,154.0,"Action,Adventure,Sci-Fi","Jun 29, 2011",195000000,352390543,1123790543,928790543
19,tt1074638,Skyfall,143.0,"Action,Adventure,Thriller","Nov 8, 2012",200000000,304360277,1110526981,910526981
22,tt2109248,Transformers: Age of Extinction,165.0,"Action,Adventure,Sci-Fi","Jun 27, 2014",210000000,245439076,1104039076,894039076
23,tt3498820,Captain America: Civil War,147.0,"Action,Adventure,Sci-Fi","May 6, 2016",250000000,408084349,1140069413,890069413
24,tt2283362,Jumanji: Welcome to the Jungle,119.0,"Action,Adventure,Comedy","Dec 20, 2017",90000000,404508916,964496193,874496193
27,tt3748528,Rogue One: A Star Wars Story,133.0,"Action,Adventure,Sci-Fi","Dec 16, 2016",200000000,532177324,1049102856,849102856
32,tt1345836,The Dark Knight Rises,164.0,"Action,Thriller","Jul 20, 2012",275000000,448139099,1084439099,809439099
36,tt1431045,Deadpool,108.0,"Action,Adventure,Comedy","Feb 12, 2016",58000000,363070709,801025593,743025593
37,tt1270797,Venom,112.0,"Action,Sci-Fi,Thriller","Oct 5, 2018",116000000,213511408,853628605,737628605
38,tt1951264,The Hunger Games: Catching Fire,146.0,"Action,Adventure,Sci-Fi","Nov 22, 2013",130000000,424668047,864868047,734868047
40,tt2250912,Spider-Man: Homecoming,133.0,"Action,Adventure,Sci-Fi","Jul 7, 2017",175000000,334201140,880166350,705166350
43,tt5463162,Deadpool 2,119.0,"Action,Adventure,Comedy","May 18, 2018",110000000,324591735,786680557,676680557
44,tt1375666,Inception,148.0,"Action,Adventure,Sci-Fi","Jul 16, 2010",160000000,292576195,835524642,675524642
45,tt0451279,Wonder Woman,141.0,"Action,Adventure,Fantasy","Jun 2, 2017",150000000,412563408,821133378,671133378
46,tt3501632,Thor: Ragnarok,130.0,"Action,Adventure,Comedy","Nov 3, 2017",180000000,315058289,846980024,666980024
48,tt1951265,The Hunger Games: Mockingjay - Part 1,123.0,"Action,Adventure,Sci-Fi","Nov 21, 2014",125000000,337135885,766575131,641575131
50,tt1298650,Pirates of the Caribbean: On Stranger Tides,136.0,"Action,Adventure,Fantasy","May 20, 2011",410600000,241063875,1045663875,635063875
53,tt2975590,Batman v Superman: Dawn of Justice,151.0,"Action,Adventure,Fantasy","Mar 25, 2016",250000000,330360194,867500281,617500281
55,tt2015381,Guardians of the Galaxy,121.0,"Action,Adventure,Comedy","Aug 1, 2014",170000000,333172112,770867516,600867516
56,tt1392170,The Hunger Games,142.0,"Action,Adventure,Sci-Fi","Mar 23, 2012",80000000,408010692,677923379,597923379
59,tt2379713,Spectre,148.0,"Action,Adventure,Thriller","Nov 6, 2015",300000000,200074175,879620923,579620923
60,tt1587310,Maleficent,97.0,"Action,Adventure,Family","May 30, 2014",180000000,241407328,758536735,578536735
61,tt1386697,Suicide Squad,123.0,"Action,Adventure,Fantasy","Aug 5, 2016",175000000,325100054,746059887,571059887
63,tt1790809,Pirates of the Caribbean: Dead Men Tell No Tales,129.0,"Action,Adventure,Fantasy","May 26, 2017",230000000,172558876,788241137,558241137
64,tt1877832,X-Men: Days of Future Past,132.0,"Action,Adventure,Sci-Fi","May 23, 2014",200000000,233921534,747862775,547862775
66,tt1843866,Captain America: The Winter Soldier,136.0,"Action,Adventure,Sci-Fi","Apr 4, 2014",170000000,259746958,714401889,544401889
68,tt2103281,Dawn of the Planet of the Apes,130.0,"Action,Adventure,Drama","Jul 11, 2014",170000000,208545589,710644566,540644566
69,tt0948470,The Amazing Spider-Man,136.0,"Action,Adventure,Sci-Fi","Jul 3, 2012",220000000,262030663,757890267,537890267
71,tt1302011,Kung Fu Panda 2,90.0,"Action,Adventure,Animation","May 26, 2011",150000000,165249063,664837547,514837547
72,tt1211837,Doctor Strange,115.0,"Action,Adventure,Fantasy","Nov 4, 2016",165000000,232641920,676404566,511404566
73,tt1872181,The Amazing Spider-Man 2,142.0,"Action,Adventure,Sci-Fi","May 2, 2014",200000000,202853933,708996336,508996336
76,tt1596343,Fast Five,130.0,"Action,Crime,Thriller","Apr 29, 2011",125000000,210031325,630163454,505163454
80,tt1981115,Thor: The Dark World,112.0,"Action,Adventure,Fantasy","Nov 8, 2013",150000000,206362140,644602516,494602516
81,tt5095030,Ant-Man and the Wasp,118.0,"Action,Adventure,Comedy","Jul 6, 2018",130000000,216648740,623144660,493144660
82,tt2179136,American Sniper,133.0,"Action,Biography,Drama","Dec 25, 2014",58000000,350126372,547326372,489326372
83,tt1951266,The Hunger Games: Mockingjay - Part 2,137.0,"Action,Adventure,Sci-Fi","Nov 20, 2015",160000000,281723902,648986787,488986787
86,tt2245084,Big Hero 6,102.0,"Action,Adventure,Animation","Nov 7, 2014",165000000,222527828,652127828,487127828
90,tt1646971,How to Train Your Dragon 2,102.0,"Action,Adventure,Animation","Jun 13, 2014",145000000,177002924,614586270,469586270
94,tt1228705,Iron Man 2,124.0,"Action,Adventure,Sci-Fi","May 7, 2010",170000000,312433331,621156389,451156389
95,tt0770828,Man of Steel,143.0,"Action,Adventure,Sci-Fi","Jun 14, 2013",225000000,291045518,667999518,442999518
97,tt1409024,Men in Black 3,106.0,"Action,Adventure,Comedy","May 25, 2012",215000000,179020854,654213485,439213485
98,tt0481499,The Croods,98.0,"Action,Adventure,Animation","Mar 22, 2013",135000000,187168425,573068425,438068425
99,tt1677720,Ready Player One,140.0,"Action,Adventure,Sci-Fi","Mar 29, 2018",150000000,137690172,579290136,429290136
100,tt0448694,Puss in Boots,90.0,"Action,Adventure,Animation","Oct 28, 2011",130000000,149260504,554987477,424987477
102,tt1515091,Sherlock Holmes: A Game of Shadows,129.0,"Action,Adventure,Crime","Dec 16, 2011",125000000,186848418,535663443,410663443
107,tt1490017,The Lego Movie,100.0,"Action,Adventure,Animation","Feb 7, 2014",60000000,257784718,457729388,397729388
110,tt2386490,How to Train Your Dragon: The Hidden World,104.0,"Action,Adventure,Animation","Feb 22, 2019",129000000,160791800,519258283,390258283
112,tt0478970,Ant-Man,117.0,"Action,Adventure,Comedy","Jul 17, 2015",130000000,180202163,518858449,388858449
114,tt3371366,Transformers: The Last Knight,154.0,"Action,Adventure,Sci-Fi","Jun 21, 2017",217000000,130168683,602893340,385893340
116,tt1318514,Rise of the Planet of the Apes,105.0,"Action,Drama,Sci-Fi","Aug 5, 2011",93000000,176760185,470986200,377986200
117,tt2267968,Kung Fu Panda 3,95.0,"Action,Adventure,Animation","Jan 29, 2016",140000000,143528619,517599142,377599142
118,tt3731562,Kong: Skull Island,118.0,"Action,Adventure,Fantasy","Mar 10, 2017",185000000,168052812,561072059,376072059
120,tt0831387,Godzilla,123.0,"Action,Adventure,Sci-Fi","May 16, 2014",160000000,200676069,529076069,369076069
121,tt0800320,Clash of the Titans,106.0,"Action,Adventure,Fantasy","Apr 1, 2010",125000000,163214888,493214888,368214888
123,tt3385516,X-Men: Apocalypse,144.0,"Action,Adventure,Sci-Fi","May 27, 2016",178000000,155442489,542537546,364537546
124,tt4701182,Bumblebee,114.0,"Action,Adventure,Sci-Fi","Dec 21, 2018",102000000,127195589,465195589,363195589
127,tt1291150,Teenage Mutant Ninja Turtles,101.0,"Action,Adventure,Comedy","Aug 8, 2014",125000000,191204754,485004754,360004754
128,tt0974015,Justice League,120.0,"Action,Adventure,Fantasy","Nov 17, 2017",300000000,229024295,655945209,355945209
130,tt4779682,The Meg,113.0,"Action,Horror,Sci-Fi","Aug 10, 2018",178000000,145443742,529530715,351530715
132,tt5013056,Dunkirk,106.0,"Action,Drama,History","Jul 21, 2017",150000000,190068280,499837368,349837368
133,tt2126355,San Andreas,114.0,"Action,Adventure,Drama","May 29, 2015",110000000,155190832,456258539,346258539
134,tt7733440,King Kong,,"Action,Adventure","Dec 14, 2005",207000000,218080025,550517357,343517357
136,tt0816711,World War Z,116.0,"Action,Adventure,Horror","Jun 21, 2013",190000000,202359711,531514650,341514650
137,tt3450958,War for the Planet of the Apes,140.0,"Action,Adventure,Drama","Jul 14, 2017",152000000,146880162,489592267,337592267
138,tt2345759,The Mummy,110.0,"Action,Adventure,Fantasy","May 7, 1999",80000000,155385488,416385488,336385488
140,tt1397280,Taken 2,92.0,"Action,Thriller","Oct 5, 2012",45000000,139854287,377807404,332807404
142,tt0892769,How to Train Your Dragon,98.0,"Action,Adventure,Animation","Mar 26, 2010",165000000,217581232,494870992,329870992
149,tt1790864,The Maze Runner,113.0,"Action,Mystery,Sci-Fi","Sep 19, 2014",34000000,102427862,348319861,314319861
151,tt1155076,The Karate Kid,140.0,"Action,Drama,Family","Jun 11, 2010",40000000,176591618,351774938,311774938
152,tt2802144,Kingsman: The Secret Service,129.0,"Action,Adventure,Comedy","Feb 13, 2015",94000000,128261724,404561724,310561724
154,tt2231461,Rampage,107.0,"Action,Adventure,Sci-Fi","Apr 13, 2018",120000000,101028233,428056280,308056280
156,tt4649466,Kingsman: The Golden Circle,141.0,"Action,Adventure,Comedy","Sep 22, 2017",104000000,100234838,408803696,304803696
159,tt1430132,The Wolverine,126.0,"Action,Adventure,Sci-Fi","Jul 26, 2013",115000000,132556852,416456852,301456852
160,tt0800369,Thor,115.0,"Action,Adventure,Fantasy","May 6, 2011",150000000,181030624,449326618,299326618
165,tt4196776,Jason Bourne,123.0,"Action,Thriller","Jul 29, 2016",120000000,162192920,416168316,296168316
172,tt5911540,Dangal,,Action,"Dec 21, 2016",9500000,12391761,294654618,285154618
174,tt2294449,22 Jump Street,112.0,"Action,Comedy,Crime","Jun 13, 2014",50000000,191719337,331333876,281333876
175,tt2446042,Taken 3,108.0,"Action,Thriller","Jan 9, 2015",48000000,89256424,327656424,279656424
176,tt1985949,The Angry Birds Movie,97.0,"Action,Animation,Comedy","May 20, 2016",73000000,107509366,352327887,279327887
177,tt0448115,Shazam!,132.0,"Action,Adventure,Comedy","Apr 5, 2019",85000000,139606856,362899733,277899733
179,tt1408101,Star Trek Into Darkness,132.0,"Action,Adventure,Sci-Fi","May 16, 2013",190000000,228778661,467381584,277381584
182,tt2592614,Resident Evil: The Final Chapter,107.0,"Action,Horror,Sci-Fi","Jan 27, 2017",40000000,26844692,314101190,274101190
186,tt1831825,Wanted,160.0,"Action,Drama","Jun 27, 2008",75000000,134508551,342416460,267416460
188,tt0803096,Warcraft,123.0,"Action,Adventure,Fantasy","Jun 10, 2016",160000000,47225655,425522281,265522281
189,tt1289401,Ghostbusters,116.0,"Action,Comedy,Fantasy","Jun 8, 1984",30000000,242212467,295212467,265212467
192,tt1293847,xXx: Return of Xander Cage,107.0,"Action,Adventure,Thriller","Jan 20, 2017",85000000,44898413,345033359,260033359
201,tt4046784,Maze Runner: The Scorch Trials,131.0,"Action,Sci-Fi,Thriller","Sep 18, 2015",61000000,81697192,310566162,249566162
202,tt1502712,Fantastic Four,100.0,"Action,Adventure,Drama","Jul 8, 2005",87500000,154696080,333132750,245632750
204,tt0983193,The Adventures of Tintin,107.0,"Action,Adventure,Animation","Dec 21, 2011",130000000,77591831,373993951,243993951
205,tt1397514,Journey 2: The Mysterious Island,94.0,"Action,Adventure,Comedy","Feb 10, 2012",79000000,103860290,318146162,239146162
208,tt1220634,Resident Evil: Afterlife,96.0,"Action,Adventure,Horror","Sep 10, 2010",57500000,60128566,295874190,238374190
209,tt3110958,Now You See Me 2,129.0,"Action,Adventure,Comedy","Jun 10, 2016",90000000,65075540,328325007,238325007
211,tt1583421,G.I. Joe: Retaliation,110.0,"Action,Adventure,Sci-Fi","Mar 27, 2013",140000000,122523060,375740705,235740705
214,tt4849438,Baahubali 2: The Conclusion,167.0,"Action,Drama","Apr 28, 2017",30000000,18985794,263502914,233502914
215,tt0437086,Alita: Battle Angel,122.0,"Action,Adventure,Sci-Fi","Feb 14, 2019",170000000,85710210,402976036,232976036
216,tt1735898,Snow White and the Huntsman,127.0,"Action,Adventure,Drama","Jun 1, 2012",170000000,155136755,401021746,231021746
218,tt4116284,The Lego Batman Movie,104.0,"Action,Animation,Comedy","Feb 10, 2017",80000000,175750384,310660018,230660018
219,tt0458339,Captain America: The First Avenger,124.0,"Action,Adventure,Sci-Fi","Jul 22, 2011",140000000,176654505,370569776,230569776
223,tt9430578,Rocky,,"Action,Drama,Romance","Nov 21, 1976",1000000,117235147,225000000,224000000
224,tt1959490,Noah,138.0,"Action,Adventure,Drama","Mar 28, 2014",130000000,101200044,352831065,222831065
225,tt1663662,Pacific Rim,131.0,"Action,Adventure,Sci-Fi","Jul 12, 2013",190000000,101802906,411002906,221002906
226,tt1253863,300: Rise of an Empire,102.0,"Action,Fantasy,War","Mar 7, 2014",110000000,106580051,330780051,220780051
227,tt1392190,Mad Max: Fury Road,120.0,"Action,Adventure,Sci-Fi","May 15, 2015",150000000,153636354,370098020,220098020
229,tt1628841,Independence Day: Resurgence,120.0,"Action,Adventure,Sci-Fi","Jun 24, 2016",165000000,103144286,384169424,219169424
236,tt1606378,A Good Day to Die Hard,98.0,"Action,Thriller","Feb 14, 2013",92000000,67349198,304249198,212249198
237,tt1764651,The Expendables 2,103.0,"Action,Adventure,Thriller","Aug 17, 2012",100000000,85028192,311979256,211979256
254,tt1386703,Total Recall,118.0,"Action,Adventure,Mystery","Jun 1, 1990",65000000,119394839,261400000,196400000
256,tt1270798,X-Men: First Class,131.0,"Action,Adventure,Sci-Fi","Jun 3, 2011",160000000,146408305,355408305,195408305
257,tt3890160,Baby Driver,113.0,"Action,Crime,Drama","Jun 28, 2017",34000000,107825862,228104185,194104185
258,tt1631867,Edge of Tomorrow,113.0,"Action,Sci-Fi","Jun 6, 2014",178000000,100206256,370541256,192541256
260,tt1001526,Megamind,95.0,"Action,Animation,Comedy","Nov 5, 2010",130000000,148415853,321887208,191887208
261,tt1840309,Divergent,139.0,"Action,Adventure,Mystery","Mar 21, 2014",85000000,150947895,276014965,191014965
265,tt2404463,The Heat,117.0,"Action,Comedy,Crime","Jun 28, 2013",43000000,159581587,229727774,186727774
266,tt1320253,The Expendables,103.0,"Action,Adventure,Thriller","Aug 13, 2010",82000000,103068524,268268174,186268174
269,tt1365519,Tomb Raider,119.0,"Action,Adventure,Fantasy","Mar 16, 2018",90000000,58250803,273477501,183477501
272,tt1267297,Hercules,98.0,"Action,Adventure,Fantasy","Jun 13, 1997",70000000,99112101,250700000,180700000
273,tt5758778,Skyscraper,102.0,"Action,Adventure,Thriller","Jul 13, 2018",125000000,68420120,304115534,179115534
275,tt1243957,The Tourist,103.0,"Action,Adventure,Thriller","Dec 10, 2010",100000000,67631157,278731369,178731369
279,tt1855325,Resident Evil: Retribution,95.0,"Action,Horror,Sci-Fi","Sep 14, 2012",65000000,42345531,240647629,175647629
284,tt2024469,Non-Stop,106.0,"Action,Mystery,Thriller","Feb 28, 2014",50000000,91742160,222383055,172383055
285,tt5033998,Charlie's Angels,,"Action,Adventure,Comedy","Nov 3, 2000",90000000,125305545,259736090,169736090
286,tt0938283,The Last Airbender,103.0,"Action,Adventure,Family","Jul 1, 2010",150000000,131772187,319713881,169713881
287,tt0918940,The Legend of Tarzan,110.0,"Action,Adventure,Drama","Jul 1, 2016",180000000,126643061,348902025,168902025
289,tt1489889,Central Intelligence,107.0,"Action,Comedy,Crime","Jun 17, 2016",50000000,127440871,217194805,167194805
296,tt1428538,Hansel & Gretel: Witch Hunters,88.0,"Action,Fantasy,Horror","Jan 25, 2013",50000000,55703475,214949716,164949716
300,tt1446192,Rise of the Guardians,97.0,"Action,Adventure,Animation","Nov 21, 2012",145000000,103412758,306900902,161900902
305,tt1232829,21 Jump Street,109.0,"Action,Comedy,Crime","Mar 16, 2012",42000000,138447667,202812429,160812429
306,tt0944835,Salt,100.0,"Action,Mystery,Thriller","Jul 23, 2010",130000000,118311368,290650494,160650494
310,tt0790724,Jack Reacher,130.0,"Action,Crime,Thriller","Dec 21, 2012",60000000,80070736,217370736,157370736
313,tt2719848,Everest,121.0,"Action,Adventure,Biography","Sep 18, 2015",65000000,43482270,221297061,156297061
316,tt1194173,The Bourne Legacy,135.0,"Action,Adventure,Thriller","Aug 10, 2012",125000000,113203870,280355920,155355920
317,tt1646987,Wrath of the Titans,99.0,"Action,Adventure,Fantasy","Mar 30, 2012",150000000,83670083,305270083,155270083
321,tt1664775,Pixels,100.0,"Action,Comedy","Jul 24, 2015",90000000,78765986,244041804,154041804
322,tt0433035,Real Steel,127.0,"Action,Drama,Family","Oct 7, 2011",110000000,85463309,263880341,153880341
324,tt1116184,Jackass 3D,95.0,"Action,Comedy,Documentary","Oct 15, 2010",20000000,117229692,171685793,151685793
326,tt2660888,Star Trek Beyond,122.0,"Action,Adventure,Sci-Fi","Jul 22, 2016",185000000,158848340,335802233,150802233
327,tt0829150,Dracula Untold,92.0,"Action,Drama,Fantasy","Oct 10, 2014",70000000,55991880,220241723,150241723
330,tt5521836,Panic Room,,"Action,Drama,Mystery","Mar 29, 2002",48000000,95308367,196308367,148308367
337,tt2347134,Unforgiven,135.0,"Action,Crime,Drama","Aug 7, 1992",14400000,101157447,159157447,144757447
340,tt6840314,City of Angels,,"Action,Drama,Horror","Apr 10, 1998",55000000,78750909,198750909,143750909
341,tt1013743,Knight and Day,109.0,"Action,Adventure,Comedy","Jun 23, 2010",117000000,76423035,258751370,141751370
344,tt1276104,Looper,113.0,"Action,Crime,Drama","Sep 28, 2012",30000000,66486205,170466405,140466405
348,tt0455944,The Equalizer,132.0,"Action,Crime,Thriller","Sep 26, 2014",55000000,101530738,192903624,137903624
353,tt1253864,Immortals,110.0,"Action,Drama,Fantasy","Nov 11, 2011",75000000,83504017,211562435,136562435
355,tt2557478,Pacific Rim: Uprising,111.0,"Action,Adventure,Sci-Fi","Mar 23, 2018",155000000,59874525,290930148,135930148
357,tt3300542,London Has Fallen,99.0,"Action,Thriller","Mar 4, 2016",60000000,62524260,195194085,135194085
364,tt2713180,Fury,134.0,"Action,Drama,War","Oct 17, 2014",80000000,85817906,210315681,130315681
365,tt1637688,In Time,109.0,"Action,Crime,Drama","Oct 28, 2011",35000000,37553932,165103952,130103952
371,tt3741700,Godzilla: King of the Monsters,132.0,"Action,Adventure,Fantasy","May 31, 2019",170000000,85576941,299276941,129276941
373,tt2263520,Ride Along,87.0,Action,"Jan 17, 2014",25000000,134202565,153733800,128733800
375,tt1528100,Exodus: Gods and Kings,150.0,"Action,Adventure,Drama","Dec 12, 2014",140000000,65014513,268314513,128314513
376,tt2369135,Need for Speed,132.0,"Action,Crime,Thriller","Mar 14, 2014",66000000,43568507,194169619,128169619
386,tt6133466,The First Purge,98.0,"Action,Horror,Sci-Fi","Jul 4, 2018",13000000,69488745,136617305,123617305
387,tt10467112,Safe House,,Action,"Feb 10, 2012",85000000,126181630,208542162,123542162
388,tt1234721,RoboCop,117.0,"Action,Crime,Sci-Fi","Feb 12, 2014",120000000,58607007,242981799,122981799
393,tt1815862,After Earth,100.0,"Action,Adventure,Drama","May 31, 2013",130000000,60522097,251499665,121499665
396,tt1981128,Geostorm,109.0,"Action,Sci-Fi,Thriller","Oct 20, 2017",100000000,33700160,220796009,120796009
401,tt1634122,Johnny English Reborn,101.0,"Action,Adventure,Comedy","Oct 21, 2011",45000000,8406711,164640401,119640401
402,tt0990407,The Green Hornet,119.0,"Action,Comedy,Crime","Jan 14, 2011",110000000,98780042,229155503,119155503
404,tt3778644,Solo: A Star Wars Story,135.0,"Action,Adventure,Fantasy","May 25, 2018",275000000,213767512,393151347,118151347
408,tt1469304,Baywatch,116.0,"Action,Comedy,Crime","May 25, 2017",60000000,58060186,175863783,115863783
412,tt7961060,Dragon Ball Super: Broly,100.0,"Action,Adventure,Animation","Jan 16, 2019",8500000,30376755,122747755,114247755
414,tt2548096,The Queen,104.0,"Action,Drama,War","Sep 30, 2006",15000000,56441711,128885873,113885873
415,tt3766354,The Equalizer 2,121.0,"Action,Crime,Thriller","Jul 20, 2018",77000000,102084362,190453132,113453132
417,tt2140479,The Accountant,128.0,"Action,Crime,Drama","Oct 14, 2016",40000000,86260045,152962083,112962083
419,tt4532826,Robin Hood,116.0,"Action,Adventure,Thriller","May 14, 2010",210000000,105487148,322459006,112459006
429,tt3949660,Teenage Mutant Ninja Turtles: Out of the Shadows,112.0,"Action,Adventure,Comedy","Jun 3, 2016",135000000,82051601,245328374,110328374
430,tt1091191,Lone Survivor,121.0,"Action,Biography,Drama","Dec 25, 2013",40000000,125095601,149804632,109804632
431,tt2333784,The Expendables 3,126.0,"Action,Adventure,Thriller","Aug 15, 2014",100000000,39322544,209461378,109461378
433,tt3863552,Bajrangi Bhaijaan,163.0,"Action,Comedy,Drama","Jul 17, 2015",13000000,8178001,121778347,108778347
434,tt4094724,The Purge: Election Year,108.0,"Action,Horror,Sci-Fi","Jul 1, 2016",10000000,79042440,118514727,108514727
435,tt0945513,Source Code,93.0,"Action,Drama,Sci-Fi","Apr 1, 2011",32000000,54712227,140428499,108428499
439,tt2133340,The Foreigner,145.0,Action,"Oct 13, 2017",35000000,34393507,140783360,105783360
448,tt2302755,Olympus Has Fallen,119.0,"Action,Thriller","Mar 22, 2013",70000000,98927592,172878928,102878928
449,tt2975578,The Purge: Anarchy,103.0,"Action,Horror,Sci-Fi","Jul 18, 2014",9000000,71562550,111534881,102534881
450,tt0293429,Mortal Kombat,,"Action,Adventure,Fantasy","Aug 18, 1995",20000000,70433227,122133227,102133227
457,tt3393786,Jack Reacher: Never Go Back,118.0,"Action,Thriller","Oct 21, 2016",60000000,58697076,159946489,99946489
472,tt1440129,Battleship,131.0,"Action,Adventure,Sci-Fi","May 18, 2012",220000000,65233400,313477717,93477717
476,tt1071875,Ghost Rider: Spirit of Vengeance,96.0,"Action,Fantasy,Thriller","Feb 17, 2012",57000000,51774002,149217355,92217355
477,tt1596350,This Means War,103.0,"Action,Comedy,Romance","Feb 17, 2012",65000000,54760791,156974557,91974557
480,tt1038919,The Bounty Hunter,110.0,"Action,Comedy,Romance","Mar 19, 2010",45000000,67061228,135808837,90808837
486,tt2091256,Captain Underpants: The First Epic Movie,89.0,"Action,Animation,Comedy","Jun 2, 2017",38000000,73921000,126577874,88577874
491,tt1424381,Predators,107.0,"Action,Adventure,Sci-Fi","Jul 9, 2010",40000000,52000688,127234389,87234389
500,tt3532216,American Made,115.0,"Action,Biography,Comedy","Sep 29, 2017",50000000,51342000,135569212,85569212
506,tt2869728,Ride Along 2,102.0,"Action,Comedy,Crime","Jan 15, 2016",40000000,90862685,124827316,84827316
522,tt2704998,Game Night,100.0,"Action,Comedy,Crime","Feb 23, 2018",37000000,69179066,117378084,80378084
530,tt1037705,The Book of Eli,118.0,"Action,Adventure,Drama","Jan 15, 2010",80000000,94835059,158750817,78750817
532,tt2241035,The Color Purple,97.0,"Action,Drama","Dec 18, 1985",15000000,93589701,93589701,78589701
535,tt1598778,Contagion,106.0,"Action,Drama,Thriller","Sep 9, 2011",60000000,75658097,137551594,77551594
536,tt1825801,Hostel,111.0,"Action,Crime,Drama","Jan 6, 2006",4800000,47326473,82241110,77441110
538,tt2873282,Red Sparrow,140.0,"Action,Drama,Thriller","Mar 2, 2018",69000000,46874505,145951861,76951861
544,tt2261633,Hitman,95.0,Action,"Nov 21, 2007",24000000,39687694,99135571,75135571
548,tt2529924,The Strangers,,"Action,Drama,Horror","May 30, 2008",9000000,52597610,83051676,74051676
553,tt1524137,Contraband,109.0,"Action,Crime,Drama","Jan 13, 2012",25000000,66528000,98406855,73406855
556,tt2304933,The 5th Wave,112.0,"Action,Adventure,Drama","Jan 22, 2016",38000000,34912982,111336398,73336398
562,tt2404435,The Magnificent Seven,132.0,"Action,Adventure,Western","Sep 23, 2016",90000000,93432655,162525156,72525156
569,tt1272878,2 Guns,109.0,"Action,Comedy,Crime","Aug 2, 2013",61000000,75612460,132493015,71493015
570,tt3829266,The Predator,107.0,"Action,Adventure,Sci-Fi","Sep 14, 2018",88000000,51024708,159487563,71487563
571,tt1205537,Jack Ryan: Shadow Recruit,105.0,"Action,Drama,Thriller","Jan 17, 2014",60000000,50577412,131377412,71377412
574,tt1386588,The Other Guys,107.0,"Action,Comedy,Crime","Aug 6, 2010",100000000,119219978,170936470,70936470
577,tt1591479,Act of Valor,110.0,"Action,Adventure,Drama","Feb 24, 2012",12000000,70012847,82497035,70497035
578,tt1611224,Abraham Lincoln: Vampire Hunter,105.0,"Action,Fantasy,Horror","Jun 22, 2012",67500000,37519139,137489730,69989730
580,tt3522806,Mechanic: Resurrection,98.0,"Action,Adventure,Thriller","Aug 26, 2016",40000000,21218403,109738840,69738840
581,tt3450650,Paul Blart: Mall Cop 2,94.0,"Action,Comedy,Crime","Apr 17, 2015",38000000,71091594,107650646,69650646
582,tt1250777,Kick-Ass,117.0,"Action,Comedy","Apr 16, 2010",28000000,48071303,97531134,69531134
588,tt2406566,Atomic Blonde,115.0,"Action,Mystery,Thriller","Jul 28, 2017",30000000,51573925,98345423,68345423
598,tt0429493,The A-Team,117.0,"Action,Adventure,Thriller","Jun 11, 2010",110000000,77222099,177241171,67241171
606,tt6593054,Drive,147.0,"Action,Crime,Drama","Sep 16, 2011",15000000,35060689,81357930,66357930
609,tt0471042,Tower Heist,104.0,"Action,Comedy,Crime","Nov 4, 2011",85000000,78046570,150422946,65422946
620,tt4832640,Sultan,170.0,"Action,Drama,Sport","Jul 6, 2016",11000000,5599781,72989781,61989781
621,tt1590193,The Commuter,105.0,"Action,Mystery,Thriller","Jan 12, 2018",40000000,36343858,101985431,61985431
637,tt2058673,Point Break,114.0,"Action,Crime,Sport","Jul 12, 1991",24000000,43218387,83531958,59531958
639,tt0816462,Conan the Barbarian,113.0,"Action,Adventure,Fantasy","May 14, 1982",20000000,38264085,79114085,59114085
646,tt1564585,Skyline,92.0,"Action,Sci-Fi,Thriller","Nov 12, 2010",10000000,21416355,68264973,58264973
647,tt2638144,Ben-Hur,123.0,"Action,Adventure,Drama","Nov 18, 1959",15000000,73000000,73259017,58259017
649,tt0963966,The Sorcerer's Apprentice,109.0,"Action,Adventure,Family","Jul 14, 2010",160000000,63150991,217986320,57986320
652,tt1219827,Ghost in the Shell,107.0,"Action,Drama,Sci-Fi","Mar 31, 2017",110000000,40563557,167910690,57910690
653,tt1821694,RED 2,116.0,"Action,Comedy,Crime","Jul 19, 2013",84000000,53262560,141507355,57507355
659,tt1411250,Riddick,119.0,"Action,Adventure,Sci-Fi","Sep 6, 2013",38000000,42025135,94763758,56763758
660,tt1601913,The Grey,117.0,"Action,Adventure,Drama","Jan 27, 2012",25000000,51580136,81249176,56249176
661,tt1823672,Chappie,120.0,"Action,Crime,Drama","Mar 6, 2015",49000000,31569268,105002056,56002056
667,tt2334879,White House Down,131.0,"Action,Drama,Thriller","Jun 28, 2013",150000000,73103784,205440387,55440387
669,tt1980209,Pain & Gain,129.0,"Action,Comedy,Crime","Apr 26, 2013",26000000,49875291,81275291,55275291
675,tt3397884,Sicario,121.0,"Action,Crime,Drama","Sep 18, 2015",30000000,46889293,84393749,54393749
677,tt4463894,Shaft,,"Action,Comedy,Crime","Jun 16, 2000",53012938,70327868,107190108,54177170
680,tt2855236,Big Fish,103.0,Action,"Dec 10, 2003",70000000,66432867,123954323,53954323
682,tt1648190,The Dark Tower,95.0,"Action,Adventure,Fantasy","Aug 4, 2017",60000000,50701325,113461527,53461527
687,tt3014284,The Lego Ninjago Movie,101.0,"Action,Adventure,Animation","Sep 22, 2017",70000000,59281555,122737201,52737201
692,tt1600195,Abduction,106.0,"Action,Mystery,Thriller","Sep 23, 2011",35000000,28087155,86648359,51648359
696,tt0479997,Season of the Witch,95.0,"Action,Adventure,Fantasy","Jan 7, 2011",40000000,24827228,91126600,51126600
699,tt1618442,The Last Witch Hunter,106.0,"Action,Adventure,Fantasy","Oct 23, 2015",80000000,27367660,130818912,50818912
701,tt1464174,"Big Mommas: Like Father, Like Son",107.0,"Action,Comedy,Crime","Feb 18, 2011",32000000,37915414,82332450,50332450
702,tt1259528,Den of Thieves,140.0,"Action,Crime,Drama","Jan 19, 2018",30000000,44947622,80131391,50131391
709,tt4163946,Snow Day,60.0,"Action,Documentary,Drama","Feb 11, 2000",13000000,60008303,62452927,49452927
719,tt1706620,Snowpiercer,126.0,"Action,Drama,Sci-Fi","Jun 27, 2014",40000000,4563029,88069880,48069880
721,tt2938956,The Transporter Refueled,96.0,"Action,Adventure,Crime","Sep 4, 2015",22000000,16029670,69698495,47698495
725,tt2679042,Hitman: Agent 47,96.0,"Action,Adventure,Crime","Aug 21, 2015",35000000,22467450,82182803,47182803
733,tt2911666,John Wick,101.0,"Action,Crime,Thriller","Oct 24, 2014",30000000,43037835,76235001,46235001
734,tt3717252,Underworld: Blood Wars,91.0,"Action,Adventure,Fantasy","Jan 6, 2017",35000000,30353973,81209222,46209222
738,tt1430612,Brick Mansions,90.0,"Action,Crime","Apr 25, 2014",28000000,20396829,73421224,45421224
739,tt7137846,Breaking In,88.0,"Action,Crime,Drama","May 11, 2018",6000000,46840590,51411620,45411620
742,tt7694546,Beowulf,80.0,"Action,Drama,Fantasy","Nov 16, 2007",150000000,82280579,195080579,45080579
748,tt1321870,Gangster Squad,113.0,"Action,Crime,Drama","Jan 11, 2013",60000000,46000903,104100903,44100903
751,tt0882977,Snitch,112.0,"Action,Drama,Thriller","Feb 22, 2013",15000000,42930462,57907734,42907734
755,tt1855199,End of Watch,109.0,"Action,Crime,Drama","Sep 21, 2012",15000000,41003371,57586606,42586606
765,tt1038686,Legion,100.0,"Action,Fantasy,Horror","Jan 22, 2010",26000000,40168080,67647574,41647574
772,tt2011159,No Good Deed,84.0,"Action,Crime,Drama","Sep 12, 2014",13200000,52543632,54323210,41123210
773,tt5052474,Sicario: Day of the Soldado,122.0,"Action,Crime,Drama","Jun 29, 2018",35000000,50065850,75885196,40885196
782,tt2274648,Hellboy,120.0,"Action,Adventure,Fantasy","Apr 2, 2004",60000000,59623958,99823958,39823958
784,tt1219342,Legend of the Guardians: The Owls of Ga'Hoole,97.0,"Action,Adventure,Animation","Sep 24, 2010",100000000,55675313,139716717,39716717
788,tt1135084,Takers,107.0,"Action,Crime,Thriller","Aug 27, 2010",32000000,57744720,70587268,38587268
789,tt1781922,No Escape,103.0,"Action,Thriller","Aug 26, 2015",5000000,27288872,42844516,37844516
798,tt1458175,The Next Three Days,133.0,"Action,Crime,Drama","Nov 19, 2010",30000000,21148651,67255916,37255916
807,tt1964418,Tomorrowland,130.0,"Action,Adventure,Family","May 22, 2015",170000000,93436322,206627518,36627518
812,tt1413492,12 Strong,130.0,"Action,Drama,History","Jan 19, 2018",35000000,45819713,71118378,36118378
819,tt7393218,Shooter,130.0,"Action,Romance","Mar 23, 2007",60000000,47003582,95538560,35538560
820,tt6173644,Derailed,107.0,"Action,Crime","Nov 11, 2005",22000000,36020063,57520063,35520063
821,tt0993842,Hanna,111.0,"Action,Drama,Thriller","Apr 8, 2011",30000000,40259119,65343694,35343694
824,tt1650554,Kick-Ass 2,103.0,"Action,Comedy,Crime","Aug 16, 2013",28000000,28795985,63129909,35129909
825,tt2239822,Valerian and the City of a Thousand Planets,137.0,"Action,Adventure,Fantasy","Jul 21, 2017",180000000,40479370,215098356,35098356
831,tt0365907,A Walk Among the Tombstones,114.0,"Action,Crime,Drama","Sep 19, 2014",28000000,26017685,62108587,34108587
832,tt0985694,Machete,105.0,"Action,Crime,Thriller","Sep 3, 2010",12500000,26593646,46370970,33870970
834,tt0472399,The Mechanic,93.0,"Action,Crime,Thriller","Jan 28, 2011",42500000,29121498,76347393,33847393
835,tt1211956,Escape Plan,115.0,"Action,Crime,Mystery","Oct 18, 2013",70000000,25135965,103735965,33735965
839,tt2385003,Assassins,84.0,"Action,Drama,Thriller","Oct 6, 1995",50000000,30306268,83306268,33306268
841,tt1657507,Colombiana,108.0,"Action,Drama,Thriller","Aug 26, 2011",40000000,36665854,72295262,32295262
848,tt4560436,Mile 22,94.0,"Action,Adventure,Thriller","Aug 17, 2018",35000000,36108758,66295121,31295121
849,tt1648179,Here Comes the Boom,105.0,"Action,Comedy,Sport","Oct 12, 2012",42000000,45290318,73239258,31239258
854,tt8404256,Snake Eyes,,"Action,Adventure","Aug 7, 1998",73000000,55591409,103891409,30891409
870,tt2312718,Homefront,100.0,"Action,Thriller","Nov 27, 2013",22000000,20158492,51695362,29695362
884,tt1371111,Cloud Atlas,172.0,"Action,Drama,Mystery","Oct 26, 2012",102000000,27108272,130673154,28673154
888,tt1921064,Pompeii,105.0,"Action,Adventure,Drama","Feb 21, 2014",80000000,23169033,108469033,28469033
889,tt8781832,Lawless,90.0,"Action,Adventure,Documentary","Aug 29, 2012",26000000,37397291,54393687,28393687
890,tt1093357,The Darkest Hour,89.0,"Action,Adventure,Horror","Dec 25, 2011",34800000,21443494,62831715,28031715
891,tt1287468,Cats & Dogs: The Revenge of Kitty Galore,82.0,"Action,Comedy,Family","Jul 30, 2010",85000000,43585753,113026383,28026383
896,tt1213663,The World's End,109.0,"Action,Comedy,Sci-Fi","Aug 23, 2013",20000000,26004851,47508505,27508505
901,tt6850820,Peppermint,101.0,"Action,Crime,Drama","Sep 7, 2018",25000000,35418723,51800758,26800758
906,tt3231054,Risen,107.0,"Action,Adventure,Drama","Feb 19, 2016",20000000,36880033,46255763,26255763
910,tt1853739,You're Next,95.0,"Action,Comedy,Horror","Aug 23, 2013",1000000,18494006,26887177,25887177
913,tt2582782,Hell or High Water,102.0,"Action,Crime,Drama","Aug 12, 2016",12000000,27007844,37584304,25584304
920,tt2658126,Commando,124.0,"Action,Thriller","Oct 4, 1985",10000000,35073978,35073978,25073978
921,tt7146054,The Guardian,93.0,"Action,Animation,Fantasy","Sep 29, 2006",70000000,55011732,94973540,24973540
923,tt10388520,Hero,,Action,"Oct 2, 1992",42000000,19487173,66787173,24787173
933,tt0822847,Priest,87.0,"Action,Adventure,Fantasy","May 13, 2011",60000000,29136626,84154026,24154026
952,tt4302938,Kubo and the Two Strings,101.0,"Action,Adventure,Animation","Aug 19, 2016",55000000,48023088,77548122,22548122
953,tt3717490,Power Rangers,124.0,"Action,Adventure,Sci-Fi","Mar 24, 2017",120000000,85364450,142531552,22531552
957,tt6175394,Posledniy bogatyr,114.0,"Action,Adventure,Comedy","Dec 31, 2017",8500000,0,30700192,22200192
978,tt7933248,The Player,,Action,"Apr 10, 1992",8000000,21706101,28876702,20876702
986,tt1103153,Killers,100.0,"Action,Comedy,Romance","Jun 4, 2010",75000000,47059963,95572749,20572749
996,tt2402157,The November Man,108.0,"Action,Crime,Thriller","Aug 27, 2014",15000000,25018119,34820335,19820335
1001,tt1133985,Green Lantern,114.0,"Action,Adventure,Sci-Fi","Jun 17, 2011",200000000,116601172,219535492,19535492
1007,tt1385867,Cop Out,107.0,"Action,Comedy,Crime","Feb 26, 2010",37000000,44875481,55909910,18909910
1008,tt1273678,The Spy Next Door,94.0,"Action,Comedy,Family","Jan 15, 2010",28000000,24307106,46752858,18752858
1011,tt2544766,Admiral,151.0,"Action,Adventure,Biography","Dec 31, 2008",20000000,0,38585047,18585047
1012,tt1137450,Death Wish,107.0,"Action,Crime,Drama","Mar 2, 2018",30000000,34017028,48575965,18575965
1014,tt9134678,Invincible,,Action,"Aug 25, 2006",40000000,57806952,58501127,18501127
1021,tt1731141,Ender's Game,114.0,"Action,Adventure,Fantasy","Nov 1, 2013",110000000,61737191,127983283,17983283
1027,tt3555036,Legend,168.0,"Action,Drama","Nov 20, 2015",25000000,1872994,42425450,17425450
1035,tt2199571,Run All Night,114.0,"Action,Drama,Thriller","Mar 13, 2015",50000000,26461644,66961644,16961644
1041,tt1433183,Sleeper,86.0,"Action,Horror","Dec 17, 1973",2000000,18344729,18344729,16344729
1045,tt1538403,The Mortal Instruments: City of Bones,130.0,"Action,Fantasy,Horror","Aug 21, 2013",60000000,31165421,75965567,15965567
1060,tt3072482,Hardcore Henry,96.0,"Action,Adventure,Sci-Fi","Apr 8, 2016",2000000,9252038,17187434,15187434
1067,tt0978764,Sucker Punch,110.0,"Action,Adventure,Fantasy","Mar 25, 2011",75000000,36392502,89758389,14758389
1083,tt1034389,The Eagle,114.0,"Action,Adventure,Drama","Feb 11, 2011",25000000,19490041,38993548,13993548
1085,tt1592525,Lockout,95.0,"Action,Sci-Fi,Thriller","Apr 13, 2012",20000000,14326865,33943049,13943049
1087,tt1121096,Seventh Son,102.0,"Action,Adventure,Fantasy","Feb 6, 2015",95000000,17725785,108874967,13874967
1092,tt9447594,The Gambler,121.0,"Action,Sci-Fi,Thriller","Dec 10, 2014",25000000,33680992,38718031,13718031
1098,tt1904996,Parker,118.0,"Action,Crime,Thriller","Jan 25, 2013",35000000,17616641,48543388,13543388
1100,tt1506999,Haywire,93.0,"Action,Drama,Thriller","Jan 20, 2012",23000000,18942396,36374700,13374700
1101,tt3640424,Allied,124.0,"Action,Drama,Romance","Nov 23, 2016",106000000,40098064,119266661,13266661
1102,tt0403935,Action Jackson,144.0,"Action,Thriller","Feb 12, 1988",7000000,20257000,20257000,13257000
1108,tt1622547,30 Minutes or Less,83.0,"Action,Comedy,Crime","Aug 12, 2011",28000000,37053924,40966716,12966716
1112,tt4572514,Patriots Day,133.0,"Action,Crime,Drama","Dec 21, 2016",40000000,31886361,52837989,12837989
1126,tt1298649,The Watch,102.0,"Action,Comedy,Horror","Jul 27, 2012",55000000,34353000,67130045,12130045
1134,tt1433108,Faster,98.0,"Action,Crime,Drama","Nov 24, 2010",24000000,23240020,35792945,11792945
1145,tt2172934,3 Days to Kill,117.0,"Action,Drama,Thriller","Feb 21, 2014",28000000,30697999,38959900,10959900
1151,tt2967224,Hot Pursuit,87.0,"Action,Comedy,Crime","May 8, 2015",35000000,34580201,45671512,10671512
1171,tt2069843,Maniac,160.0,"Action,Horror,Thriller","Jan 1, 1980",350000,10000000,10000000,9650000
1172,tt3799694,The Nice Guys,116.0,"Action,Comedy,Crime","May 20, 2016",50000000,36261763,59596747,9596747
1174,tt1418377,"I, Frankenstein",92.0,"Action,Fantasy,Horror","Jan 24, 2014",65000000,19075290,74575290,9575290
1183,tt2166214,Khiladi 786,141.0,"Action,Comedy","Dec 7, 2012",5600000,385422,14683763,9083763
1203,tt1198101,Kites,123.0,"Action,Drama,Romance","May 21, 2010",9200000,1685269,17155193,7955193
1206,tt6447730,Fighting,91.0,"Action,Romance,Sport","Apr 24, 2009",25000000,23091010,32831707,7831707
1208,tt0401729,John Carter,132.0,"Action,Adventure,Sci-Fi","Mar 9, 2012",275000000,73058679,282778100,7778100
1212,tt1568338,Man on a Ledge,102.0,"Action,Adventure,Crime","Jan 27, 2012",42000000,18620000,49621440,7621440
1217,tt2879218,The Collector,94.0,"Action,Comedy","Jul 31, 2009",3000000,7712114,10473836,7473836
1219,tt3014866,Criminal,113.0,"Action,Crime,Drama","Apr 15, 2016",31500000,14708696,38771262,7271262
1220,tt1258972,The Man with the Iron Fists,95.0,Action,"Nov 2, 2012",15000000,15634090,22018988,7018988
1228,tt1618430,Dum Maaro Dum,128.0,"Action,Crime,Drama","Apr 22, 2011",5200000,564489,11633427,6433427
1234,tt1984208,Moby Dick,112.0,Action,"Jun 27, 1956",4500000,10400000,10400000,5900000
1236,tt9805168,Traitor,110.0,"Action,Drama,Romance","Aug 27, 2008",22000000,23530831,27882226,5882226
1241,tt4139124,Keanu,100.0,"Action,Comedy,Crime","Apr 29, 2016",15000000,20591853,20688141,5688141
1249,tt1366365,The Cold Light of Day,93.0,"Action,Thriller","Sep 7, 2012",20000000,3763583,25361206,5361206
1252,tt1961175,American Assassin,112.0,"Action,Thriller","Sep 15, 2017",63000000,36249674,68310140,5310140
1267,tt3367294,Compadres,101.0,"Action,Comedy,Crime","Apr 22, 2016",3000000,3127773,7445044,4445044
1272,tt4073790,The Darkest Minds,104.0,"Action,Adventure,Drama","Aug 3, 2018",34000000,12695691,38361428,4361428
1291,tt4573516,Sleight,89.0,"Action,Drama,Sci-Fi","Apr 28, 2017",250000,3930990,3934450,3684450
1295,tt0857190,The Sweeney,112.0,"Action,Crime,Drama","Mar 1, 2013",4500000,26345,8000366,3500366
1300,tt6599032,Lost Souls,84.0,"Action,Drama","Oct 13, 2000",28000000,16779636,31320293,3320293
1302,tt1321511,Oldboy,104.0,"Action,Drama,Mystery","Mar 25, 2005",3000000,707391,6239723,3239723
1309,tt1617661,Jupiter Ascending,127.0,"Action,Adventure,Sci-Fi","Feb 6, 2015",179000000,47482519,181982519,2982519
1312,tt7159036,The Conversation,,Action,"Apr 7, 1974",1600000,4420000,4420000,2820000
1322,tt5719748,Cold Pursuit,119.0,"Action,Crime,Drama","Feb 8, 2019",60000000,32138862,62599159,2599159
1324,tt1727497,Control,127.0,"Action,Crime,Drama","Oct 10, 2007",6400000,871577,8902141,2502141
1330,tt3316948,American Ultra,96.0,"Action,Comedy,Sci-Fi","Aug 21, 2015",28000000,14439985,30295028,2295028
1354,tt1791679,Weekend,121.0,"Action,Comedy,Crime","Sep 23, 2011",190000,484592,1577585,1387585
1372,tt1893211,Choke,122.0,"Action,Drama,Romance","Sep 26, 2008",3400000,2926565,4124277,724277
1379,tt1727776,Scouts Guide to the Zombie Apocalypse,93.0,"Action,Comedy,Horror","Oct 30, 2015",15000000,3703046,15554855,554855
1387,tt1712170,Alex Cross,101.0,"Action,Crime,Mystery","Oct 19, 2012",35000000,25888412,35426759,426759
1394,tt5941692,Miss Bala,104.0,"Action,Crime,Drama","Feb 1, 2019",15000000,14998027,15362298,362298
1420,tt2771280,Iris,,"Action,Drama,Sci-Fi","Dec 14, 2001",5500000,5580479,5580479,80479
1474,tt8180058,Adam,,Action,"Jul 29, 2009",3200000,2283291,2834485,-365515
1485,tt2246526,Born to Fly: Elizabeth Streb vs. Gravity,82.0,"Action,Biography,Documentary","Sep 10, 2014",500000,1822,1822,-498178
1486,tt1865346,Detention of the Dead,87.0,"Action,Adventure,Comedy","Jun 28, 2013",500000,1778,1778,-498222
1487,tt2924392,Higher Power,93.0,"Action,Sci-Fi,Thriller","May 11, 2018",500000,528,528,-499472
1508,tt1966412,Destiny,,Action,"Dec 31, 2014",750000,0,450,-749550
1519,tt1907639,Hardflip,112.0,"Action,Drama","Jun 1, 2012",1000000,96734,96734,-903266
1529,tt3139764,Unsullied,93.0,"Action,Horror,Thriller","Apr 22, 2016",1500000,510957,510957,-989043
1531,tt4733536,American Hero,86.0,"Action,Comedy,Drama","Dec 11, 2015",1000000,0,26,-999974
1538,tt1748227,The Collection,82.0,"Action,Horror,Thriller","Nov 30, 2012",10000000,6810754,8890094,-1109906
1542,tt2404233,Gods of Egypt,127.0,"Action,Adventure,Fantasy","Feb 26, 2016",140000000,31153464,138836756,-1163244
1558,tt1470023,MacGruber,90.0,"Action,Comedy,Romance","May 21, 2010",10000000,8525600,8629895,-1370105
1561,tt8043306,Teefa in Trouble,155.0,"Action,Comedy,Crime","Jul 20, 2018",1500000,0,98806,-1401194
1574,tt2002718,Machete Kills,107.0,"Action,Crime,Sci-Fi","Oct 11, 2013",20000000,8008161,18273009,-1726991
1579,tt1512235,Super,96.0,"Action,Comedy,Drama","Apr 1, 2011",2500000,327716,593933,-1906067
1591,tt0873886,Red State,88.0,"Action,Crime,Horror","Sep 23, 2011",4000000,1065429,1983596,-2016404
1595,tt1640459,Hobo with a Shotgun,86.0,"Action,Comedy,Horror","May 6, 2011",3000000,703372,834953,-2165047
1600,tt5834262,Hotel Artemis,94.0,"Action,Drama,Sci-Fi","Jun 8, 2018",15000000,6708137,12758799,-2241201
1608,tt0947810,Green Zone,115.0,"Action,Drama,Thriller","Mar 12, 2010",100000000,35497337,97523020,-2476980
1617,tt1460743,Reign of Assassins,117.0,"Action,Adventure","Nov 1, 2016",14000000,0,11354230,-2645770
1618,tt3619854,Creature,134.0,"Action,Horror,Sci-Fi","Sep 9, 2011",3000000,331000,331000,-2669000
1619,tt1235189,Wild Target,98.0,"Action,Comedy,Crime","Oct 29, 2010",8000000,109338,5314194,-2685806
1620,tt3517850,12 Rounds,,"Action,Drama,Romance","Mar 27, 2009",20000000,12234694,17306648,-2693352
1627,tt5294776,Holly,,"Action,Crime,Thriller","Nov 9, 2007",3000000,163069,163069,-2836931
1635,tt1922679,Open Road,85.0,"Action,Drama,Thriller","May 21, 2013",3000000,0,47469,-2952531
1647,tt1629705,Blackthorn,102.0,"Action,Adventure,Western","Oct 7, 2011",4500000,200558,1217307,-3282693
1648,tt3103166,The Masked Saint,105.0,"Action,Biography,Crime","Jan 8, 2016",3500000,182695,182695,-3317305
1654,tt5303564,Paparazzi,110.0,"Action,Drama,Romance","Sep 3, 2004",20000000,15712072,16612072,-3387928
1657,tt2020110,The Kick,94.0,"Action,Sport","Dec 31, 2011",3500000,0,40622,-3459378
1663,tt1343727,Dredd,95.0,"Action,Crime,Sci-Fi","Sep 21, 2012",45000000,13414714,41467606,-3532394
1666,tt1547234,Premium Rush,91.0,"Action,Crime,Thriller","Aug 24, 2012",35000000,20275446,31393201,-3606799
1682,tt1844203,Inescapable,93.0,"Action,Drama,Mystery","Feb 22, 2013",4000000,4327,4327,-3995673
1686,tt2963656,The Rundown,,Action,"Sep 26, 2003",85000000,47641743,80831893,-4168107
1694,tt2295722,Falcon Rising,103.0,"Action,Adventure","Sep 4, 2014",4500000,11774,11774,-4488226
1696,tt1448755,Killer Elite,116.0,"Action,Crime,Thriller","Sep 23, 2011",70000000,25124986,65409046,-4590954
1702,tt2437096,Black and White,,Action,"Apr 5, 2000",10000000,5241315,5241315,-4758685
1703,tt10300710,Hit & Run,114.0,"Action,Comedy","Aug 22, 2012",22000000,13749300,17216955,-4783045
1711,tt3469440,Z Storm,92.0,"Action,Crime","Aug 18, 2015",7000000,0,2053330,-4946670
1713,tt3838992,Yoga Hosers,88.0,"Action,Comedy,Fantasy","Sep 2, 2016",5000000,0,22958,-4977042
1730,tt7137380,Destroyer,121.0,"Action,Crime,Drama","Dec 25, 2018",9000000,1533324,3681096,-5318904
1731,tt2345737,The Rover,103.0,"Action,Crime,Drama","Jun 13, 2014",8500000,1109199,3180252,-5319748
1736,tt1472584,Max Steel,92.0,"Action,Adventure,Family","Oct 14, 2016",10000000,3818664,4563080,-5436920
1738,tt10329842,Geroy,,Action,"Dec 31, 2015",7000000,0,1545121,-5454879
1739,tt1251743,Salvation Boulevard,96.0,"Action,Comedy,Drama","Jul 15, 2011",5500000,28468,28468,-5471532
1744,tt5112932,Heist,47.0,Action,"Nov 13, 2015",8900000,50136,3324131,-5575869
1749,tt1598828,One for the Money,91.0,"Action,Comedy,Crime","Jan 27, 2012",42000000,26414527,36197221,-5802779
1757,tt2167202,Getaway,90.0,"Action,Crime,Thriller","Aug 30, 2013",18000000,10501938,11813989,-6186011
1758,tt4158096,Free Fire,91.0,"Action,Comedy,Crime","Apr 21, 2017",10000000,1799322,3793739,-6206261
1760,tt3381008,The Brothers Grimsby,83.0,"Action,Adventure,Comedy","Mar 11, 2016",35000000,6864016,28720470,-6279530
1766,tt1414378,Tracker,102.0,"Action,Adventure,Drama","Dec 31, 2011",6500000,0,3149,-6496851
1768,tt1478964,Attack the Block,88.0,"Action,Comedy,Sci-Fi","Jul 29, 2011",13000000,1024175,6459183,-6540817
1780,tt1020558,Centurion,97.0,"Action,Adventure,Drama","Aug 27, 2010",15000000,123570,7885048,-7114952
1784,tt2147225,Black November,95.0,"Action,Crime,Drama","Jan 9, 2015",7500000,0,32572,-7467428
1788,tt0485985,Red Tails,125.0,"Action,Adventure,Drama","Jan 20, 2012",58000000,49876377,50365498,-7634502
1789,tt2923316,American Heist,94.0,"Action,Crime,Drama","Jul 21, 2015",10000000,0,2341218,-7658782
1794,tt2112277,Swelter,96.0,"Action,Crime,Drama","Aug 12, 2014",8000000,0,44197,-7955803
1796,tt1134795,Akira,,"Action,Drama,Mystery","Apr 27, 2001",8000000,19585,19585,-7980415
1803,tt6421110,Proud Mary,89.0,"Action,Crime,Drama","Jan 12, 2018",30000000,20868638,21709539,-8290461
1807,tt3910736,Gun Shy,92.0,"Action,Adventure,Comedy","Feb 4, 2000",10000000,1638202,1638202,-8361798
1817,tt1502404,Drive Angry,104.0,"Action,Fantasy,Thriller","Feb 25, 2011",50000000,10721033,41042583,-8957417
1819,tt1641841,Skin Trade,96.0,"Action,Crime,Thriller","May 8, 2015",9000000,1242,1242,-8998758
1821,tt5360952,The Hurricane Heist,103.0,"Action,Adventure,Crime","Mar 9, 2018",40000000,6115824,30963684,-9036316
1828,tt2556874,Plastic,102.0,"Action,Comedy,Crime","Sep 26, 2014",10000000,0,575371,-9424629
1829,tt1376195,Gunless,89.0,"Action,Comedy,Drama","Apr 30, 2010",9900000,458054,458054,-9441946
1837,tt7722258,Genius,165.0,"Action,Thriller","Jun 10, 2016",17000000,1361045,7265283,-9734717
1855,tt1390411,In the Heart of the Sea,122.0,"Action,Adventure,Biography","Dec 11, 2015",100000000,25020758,89693309,-10306691
1857,tt2649554,Midnight Special,112.0,"Action,Drama,Mystery","Mar 18, 2016",18000000,3712282,7680250,-10319750
1859,tt2101341,Dead Man Down,118.0,"Action,Crime,Drama","Mar 8, 2013",30000000,10895295,19599974,-10400026
1868,tt3341072,Firestorm,118.0,"Action,Crime,Thriller","Jan 9, 1998",19000000,8123860,8123860,-10876140
1870,tt1043726,The Legend of Hercules,99.0,"Action,Adventure,Fantasy","Jan 10, 2014",70000000,18848538,58953319,-11046681
1873,tt1374989,Pride and Prejudice and Zombies,108.0,"Action,Comedy,Horror","Feb 5, 2016",28000000,10907291,16638300,-11361700
1874,tt2805976,Doomsday,95.0,"Action,Sci-Fi","Mar 14, 2008",33000000,11008770,21621188,-11378812
1887,tt1486193,5 Days of War,113.0,"Action,Drama,War","Aug 19, 2011",12000000,17479,87793,-11912207
1893,tt1833673,Dhoom 3,172.0,"Action,Thriller","Dec 20, 2013",24000000,8031955,11723620,-12276380
1903,tt2631186,Baahubali: The Beginning,159.0,"Action,Drama","Jul 10, 2015",40000000,6738000,26736665,-13263335
1906,tt3829920,Only the Brave,134.0,"Action,Biography,Drama","Oct 20, 2017",38000000,18340051,24555177,-13444823
1914,tt0999913,Straw Dogs,110.0,"Action,Drama,Thriller","Sep 16, 2011",25000000,10324441,11253821,-13746179
1915,tt1053424,Repo Men,111.0,"Action,Crime,Sci-Fi","Mar 19, 2010",32000000,13942007,18195238,-13804762
1916,tt1535612,The Son of No One,90.0,"Action,Crime,Drama","Nov 4, 2011",15000000,30680,1148578,-13851422
1919,tt1013860,Dylan Dog: Dead of Night,107.0,"Action,Comedy,Crime","Apr 29, 2011",20000000,1186538,6093725,-13906275
1925,tt1571234,Mortal Engines,128.0,"Action,Adventure,Fantasy","Dec 14, 2018",100000000,15951040,85287417,-14712583
1929,tt1781827,Hands of Stone,111.0,"Action,Biography,Drama","Aug 26, 2016",20000000,4712792,5031975,-14968025
1931,tt2503954,Broken Horses,101.0,"Action,Crime,Drama","Sep 1, 2015",15000000,0,3471,-14996529
1932,tt1210819,The Lone Ranger,150.0,"Action,Adventure,Western","Jul 2, 2013",275000000,89302115,260002115,-14997885
1934,tt5721088,Just Getting Started,91.0,"Action,Comedy","Dec 8, 2017",22000000,6069605,6756412,-15243588
1945,tt1742334,Sabotage,109.0,"Action,Crime,Drama","Mar 28, 2014",35000000,10508518,18376443,-16623557
1947,tt1234719,Red Dawn,93.0,"Action,Sci-Fi,Thriller","Nov 21, 2012",65000000,44806783,48164150,-16835850
1954,tt3212232,I Am Wrath,92.0,"Action,Crime,Drama","Apr 15, 2016",18000000,0,309608,-17690392
1957,tt1403241,Wolves,91.0,"Action,Fantasy,Horror","Nov 14, 2014",18000000,0,94953,-17905047
1962,tt5024572,Rock Star,,"Action,Drama,Romance","Sep 7, 2001",38000000,16991902,19317765,-18682235
1965,tt1664697,Middle Men,82.0,"Action,Comedy,Crime","Aug 6, 2010",20000000,754301,754301,-19245699
1967,tt1438173,Bait,93.0,"Action,Adventure,Drama","Sep 15, 2000",35000000,15325127,15471969,-19528031
1968,tt1233301,Ironclad,121.0,"Action,Adventure,Drama","Jul 8, 2011",25000000,0,5297411,-19702589
1976,tt2025690,The Finest Hours,117.0,"Action,Drama,History","Jan 29, 2016",70000000,27569558,49252761,-20747239
1980,tt2140037,Jane Got a Gun,98.0,"Action,Drama,Western","Jan 29, 2016",25000000,1513793,3771345,-21228655
1984,tt2515034,The Gunman,115.0,"Action,Crime,Drama","Mar 20, 2015",40000000,10664749,18594227,-21405773
1992,tt1335975,47 Ronin,128.0,"Action,Adventure,Drama","Dec 25, 2013",175000000,38362475,151716815,-23283185
1998,tt2126235,Collide,99.0,"Action,Crime,Thriller","Feb 24, 2017",29200000,2280004,5466698,-23733302
1999,tt2720826,Birth of the Dragon,95.0,"Action,Biography,Drama","Aug 25, 2017",31000000,6901965,7220490,-23779510
2009,tt2231253,Wild Card,92.0,"Action,Crime,Drama","Jan 30, 2015",30000000,3200,4315789,-25684211
2011,tt1586752,Machine Gun Preacher,129.0,"Action,Biography,Crime","Sep 23, 2011",30000000,538690,3721988,-26278012
2015,tt1124037,Free State of Jones,139.0,"Action,Biography,Drama","Jun 24, 2016",50000000,20810036,23237252,-26762748
2019,tt3576728,Bilal: A New Breed of Hero,105.0,"Action,Adventure,Animation","Feb 2, 2018",30000000,490973,648599,-29351401
2020,tt3045616,Mortdecai,107.0,"Action,Comedy,Crime","Jan 23, 2015",60000000,7696134,30396134,-29603866
2025,tt6811018,The Kid Who Would Be King,120.0,"Action,Adventure,Family","Jan 25, 2019",59000000,16790790,28348446,-30651554
2029,tt1308729,Bullet to the Head,92.0,"Action,Crime,Thriller","Feb 1, 2013",55000000,9489829,22597969,-32402031
2030,tt1981107,The Young and Prodigious T.S. Spivet,105.0,"Action,Adventure,Comedy","Jul 31, 2015",33000000,176847,357687,-32642313
2034,tt1860357,Deepwater Horizon,107.0,"Action,Drama,History","Sep 30, 2016",156000000,61433527,122603824,-33396176
2035,tt1032751,The Warrior's Way,100.0,"Action,Fantasy,Western","Dec 3, 2010",42000000,5666340,8514325,-33485675
2036,tt3485166,Pirates,130.0,"Action,Adventure,Comedy","Jul 1, 1986",40000000,1641825,6341825,-33658175
2040,tt1321869,The Lovers,109.0,"Action,Adventure,Romance","Mar 13, 2015",35000000,0,53899,-34946101
2041,tt1972591,King Arthur: Legend of the Sword,126.0,"Action,Adventure,Drama","May 12, 2017",175000000,39175066,139630336,-35369664
2044,tt1075747,Jonah Hex,81.0,"Action,Drama,Fantasy","Jun 18, 2010",47000000,10547117,11022696,-35977304
2045,tt2032572,USS Indianapolis: Men of Courage,128.0,"Action,Drama,History","Nov 11, 2016",40000000,0,1663785,-38336215
2046,tt1754651,The Last Shot,47.0,Action,"Sep 24, 2004",40000000,463730,463730,-39536270
2052,tt2361317,Live by Night,129.0,"Action,Crime,Drama","Dec 25, 2016",65000000,10378555,21774432,-43225568
2054,tt8643442,Virus,,Action,"Jan 15, 1999",75000000,14010690,30626690,-44373310
2055,tt0249516,Foodfight!,91.0,"Action,Animation,Comedy","Dec 31, 2012",45000000,0,73706,-44926294
2059,tt1727261,Father's Day,99.0,"Action,Comedy,Horror","May 9, 1997",85000000,28681080,35681080,-49318920
2060,tt2717822,Blackhat,133.0,"Action,Crime,Thriller","Jan 16, 2015",70000000,8005980,19665004,-50334996
2061,tt0790736,R.I.P.D.,96.0,"Action,Adventure,Comedy","Jul 19, 2013",130000000,33618855,79076678,-50923322
2064,tt2352432,Stealth,51.0,"Action,Comedy","Jul 29, 2005",138000000,32116746,76416746,-61583254
2065,tt3095734,Monster Trucks,104.0,"Action,Adventure,Comedy","Jan 13, 2017",125000000,33370166,61642798,-63357202
2066,tt4743226,Air Strike,120.0,"Action,Adventure,Drama","Oct 26, 2018",65000000,0,516279,-64483721
2067,tt1041804,The Nutcracker in 3D,110.0,"Action,Family,Fantasy","Nov 24, 2010",90000000,195459,20466016,-69533984
2068,tt2283336,Men in Black: International,115.0,"Action,Adventure,Comedy","Jun 14, 2019",110000000,3100000,3100000,-106900000
2070,tt6565702,Dark Phoenix,113.0,"Action,Adventure,Sci-Fi","Jun 7, 2019",350000000,42762350,149762350,-200237650
