,tconst,primary_title,runtime_minutes,genres,release_date,production_budget,domestic_gross,worldwide_gross,total_profit
10,tt2293640,Minions,91.0,"Adventure,Animation,Comedy","Jul 10, 2015",74000000,336045770,1160336173,1086336173
16,tt3469046,Despicable Me 3,89.0,"Adventure,Animation,Comedy","Jun 30, 2017",75000000,264624300,1034727750,959727750
21,tt1690953,Despicable Me 2,98.0,"Adventure,Animation,Comedy","Jul 3, 2013",76000000,368065385,975216835,899216835
24,tt2283362,Jumanji: Welcome to the Jungle,119.0,"Action,Adventure,Comedy","Dec 20, 2017",90000000,404508916,964496193,874496193
25,tt2948356,Zootopia,108.0,"Adventure,Animation,Comedy","Mar 4, 2016",150000000,341268248,1019429616,869429616
26,tt0435761,Toy Story 3,103.0,"Adventure,Animation,Comedy","Jun 18, 2010",200000000,415004880,1068879522,868879522
30,tt2277860,Finding Dory,97.0,"Adventure,Animation,Comedy","Jun 17, 2016",200000000,486295561,1021215193,821215193
31,tt2709768,The Secret Life of Pets,87.0,"Adventure,Animation,Comedy","Jul 8, 2016",75000000,368384330,886750534,811750534
34,tt1667889,Ice Age: Continental Drift,88.0,"Adventure,Animation,Comedy","Jul 13, 2012",95000000,161321843,879765137,784765137
36,tt1431045,Deadpool,108.0,"Action,Adventure,Comedy","Feb 12, 2016",58000000,363070709,801025593,743025593
43,tt5463162,Deadpool 2,119.0,"Action,Adventure,Comedy","May 18, 2018",110000000,324591735,786680557,676680557
46,tt3501632,Thor: Ragnarok,130.0,"Action,Adventure,Comedy","Nov 3, 2017",180000000,315058289,846980024,666980024
54,tt1277953,Madagascar 3: Europe's Most Wanted,93.0,"Adventure,Animation,Comedy","Jun 8, 2012",145000000,216391482,746921271,601921271
55,tt2015381,Guardians of the Galaxy,121.0,"Action,Adventure,Comedy","Aug 1, 2014",170000000,333172112,770867516,600867516
57,tt0892791,Shrek Forever After,93.0,"Adventure,Animation,Comedy","May 21, 2010",165000000,238736787,756244673,591244673
62,tt3470600,Sing,108.0,"Animation,Comedy,Family","Dec 21, 2016",75000000,270329045,634454789,559454789
67,tt1453405,Monsters University,104.0,"Adventure,Animation,Comedy","Jun 21, 2013",200000000,268488329,743588329,543588329
74,tt1411697,The Hangover Part II,102.0,"Comedy,Mystery","May 26, 2011",80000000,254464305,586464305,506464305
75,tt1637725,Ted,106.0,"Comedy,Fantasy","Jun 29, 2012",50000000,218665740,556016627,506016627
81,tt5095030,Ant-Man and the Wasp,118.0,"Action,Adventure,Comedy","Jul 6, 2018",130000000,216648740,623144660,493144660
84,tt1483010,Logan,94.0,"Comedy,Drama,Family","Mar 3, 2017",127000000,226277068,615461394,488461394
85,tt3521164,Moana,107.0,"Adventure,Animation,Comedy","Nov 23, 2016",150000000,248757044,637517365,487517365
87,tt6139732,Aladdin,128.0,"Adventure,Comedy,Family","Nov 11, 1992",28000000,217350219,504050219,476050219
89,tt1323594,Despicable Me,95.0,"Animation,Comedy,Family","Jul 9, 2010",69000000,251513985,543464573,474464573
91,tt5220122,Hotel Transylvania 3: Summer Vacation,97.0,"Adventure,Animation,Comedy","Jul 13, 2018",65000000,167500092,527079962,462079962
92,tt0472181,The Smurfs,103.0,"Adventure,Animation,Comedy","Jul 29, 2011",110000000,142614158,563749323,453749323
97,tt1409024,Men in Black 3,106.0,"Action,Adventure,Comedy","May 25, 2012",215000000,179020854,654213485,439213485
104,tt3783958,La La Land,128.0,"Comedy,Drama,Music","Dec 9, 2016",20000000,151101803,426351163,406351163
105,tt3375556,Iron Man,84.0,"Comedy,Drama,Family","May 2, 2008",186000000,318604126,585171547,399171547
111,tt2510894,Hotel Transylvania 2,89.0,"Animation,Comedy,Family","Sep 25, 2015",80000000,169700110,469500298,389500298
112,tt0478970,Ant-Man,117.0,"Action,Adventure,Comedy","Jul 17, 2015",130000000,180202163,518858449,388858449
115,tt3874544,The Boss Baby,97.0,"Adventure,Animation,Comedy","Mar 31, 2017",125000000,175003033,510878762,385878762
125,tt2357291,Rio 2,101.0,"Adventure,Animation,Comedy","Apr 11, 2014",130000000,131538435,492846291,362846291
126,tt1216475,Cars 2,106.0,"Adventure,Animation,Comedy","Jun 24, 2011",200000000,191450875,560155383,360155383
127,tt1291150,Teenage Mutant Ninja Turtles,101.0,"Action,Adventure,Comedy","Aug 8, 2014",125000000,191204754,485004754,360004754
141,tt1772341,Wreck-It Ralph,101.0,"Adventure,Animation,Comedy","Nov 2, 2012",165000000,189412677,496511521,331511521
143,tt0398286,Tangled,100.0,"Adventure,Animation,Comedy","Nov 24, 2010",260000000,200821936,586477240,326477240
152,tt2802144,Kingsman: The Secret Service,129.0,"Action,Adventure,Comedy","Feb 13, 2015",94000000,128261724,404561724,310561724
153,tt1667150,What Women Want,116.0,"Comedy,Romance,Sci-Fi","Dec 15, 2000",65000000,182805123,374105123,309105123
156,tt4649466,Kingsman: The Golden Circle,141.0,"Action,Adventure,Comedy","Sep 22, 2017",104000000,100234838,408803696,304803696
161,tt6966692,Green Book,130.0,"Biography,Comedy,Drama","Nov 16, 2018",23000000,85080171,322034439,299034439
163,tt3416828,Ice Age: Collision Course,94.0,"Adventure,Animation,Comedy","Jul 22, 2016",105000000,64063008,402156682,297156682
164,tt5117670,Peter Rabbit,95.0,"Adventure,Animation,Comedy","Feb 9, 2018",50000000,115234093,347136477,297136477
167,tt0837562,Hotel Transylvania,91.0,"Animation,Comedy,Family","Sep 28, 2012",85000000,148313048,378505812,293505812
174,tt2294449,22 Jump Street,112.0,"Action,Comedy,Crime","Jun 13, 2014",50000000,191719337,331333876,281333876
176,tt1985949,The Angry Birds Movie,97.0,"Action,Animation,Comedy","May 20, 2016",73000000,107509366,352327887,279327887
177,tt0448115,Shazam!,132.0,"Action,Adventure,Comedy","Apr 5, 2019",85000000,139606856,362899733,277899733
180,tt9574324,Chicago,,"Comedy,Crime,Drama","Dec 27, 2002",30000000,170687518,306770545,276770545
184,tt1615918,Alvin and the Chipmunks: Chipwrecked,87.0,"Adventure,Animation,Comedy","Dec 16, 2011",80000000,133107389,349088523,269088523
189,tt1289401,Ghostbusters,116.0,"Action,Comedy,Fantasy","Jun 8, 1984",30000000,242212467,295212467,265212467
193,tt2848292,Pitch Perfect 2,115.0,"Comedy,Music","May 15, 2015",29000000,184296230,287625468,258625468
194,tt1478338,Bridesmaids,125.0,"Comedy,Romance","May 13, 2011",32500000,169211718,289632023,257132023
198,tt5275314,My Best Friend's Wedding,91.0,"Comedy,Romance","Jun 20, 1997",46000000,126813153,298923419,252923419
205,tt1397514,Journey 2: The Mysterious Island,94.0,"Action,Adventure,Comedy","Feb 10, 2012",79000000,103860290,318146162,239146162
207,tt2017020,The Smurfs 2,105.0,"Adventure,Animation,Comedy","Jul 31, 2013",110000000,71017784,348547523,238547523
209,tt3110958,Now You See Me 2,129.0,"Action,Adventure,Comedy","Jun 10, 2016",90000000,65075540,328325007,238325007
210,tt2279373,The SpongeBob Movie: Sponge Out of Water,92.0,"Adventure,Animation,Comedy","Feb 6, 2015",74000000,162994032,311013181,237013181
212,tt1911658,Penguins of Madagascar,92.0,"Adventure,Animation,Comedy","Nov 26, 2014",132000000,83350911,366942531,234942531
217,tt1723121,We're the Millers,110.0,"Comedy,Crime","Aug 7, 2013",37000000,150394119,267816276,230816276
218,tt4116284,The Lego Batman Movie,104.0,"Action,Animation,Comedy","Feb 10, 2017",80000000,175750384,310660018,230660018
221,tt2692250,Night at the Museum: Secret of the Tomb,98.0,"Adventure,Comedy,Family","Dec 19, 2014",127000000,113746621,353756621,226756621
230,tt1679335,Trolls,92.0,"Adventure,Animation,Comedy","Nov 4, 2016",125000000,153707064,344150134,219150134
233,tt1045658,Silver Linings Playbook,122.0,"Comedy,Drama,Romance","Nov 16, 2012",21000000,132092958,236412453,215412453
238,tt5028340,Mary Poppins Returns,130.0,"Comedy,Family,Fantasy","Dec 19, 2018",130000000,171958438,341528518,211528518
239,tt0970866,Little Fockers,98.0,"Comedy,Romance","Dec 22, 2010",100000000,148438600,310650574,210650574
241,tt3606752,Cars 3,102.0,"Adventure,Animation,Comedy","Jun 16, 2017",175000000,152901115,383541369,208541369
243,tt3104988,Crazy Rich Asians,120.0,"Comedy,Romance","Aug 15, 2018",30000000,174532921,238099711,208099711
246,tt1109624,Paddington,95.0,"Adventure,Comedy,Family","Jan 16, 2015",55000000,76223578,258789097,203789097
248,tt6178382,Twins,8.0,"Adventure,Biography,Comedy","Dec 9, 1988",15000000,111936388,216600000,201600000
249,tt1261945,Sex and the City 2,146.0,"Comedy,Drama,Romance","May 27, 2010",95000000,95347692,294680778,199680778
252,tt1375670,Grown Ups,102.0,Comedy,"Jun 25, 2010",75000000,162001186,272223430,197223430
253,tt1284575,Bad Teacher,92.0,"Comedy,Romance","Jun 24, 2011",19000000,100292856,215448997,196448997
255,tt1985966,Cloudy with a Chance of Meatballs 2,95.0,"Adventure,Animation,Comedy","Sep 27, 2013",78000000,119793567,274392649,196392649
260,tt1001526,Megamind,95.0,"Action,Animation,Comedy","Nov 5, 2010",130000000,148415853,321887208,191887208
264,tt1605630,American Reunion,113.0,Comedy,"Apr 6, 2012",50000000,56758835,236799211,186799211
265,tt2404463,The Heat,117.0,"Action,Comedy,Crime","Jun 28, 2013",43000000,159581587,229727774,186727774
270,tt9691476,Snow White and the Seven Dwarfs,,"Comedy,Drama,Fantasy","Dec 21, 1937",1488000,184925486,184925486,183437486
274,tt3411444,Ferdinand,108.0,"Adventure,Animation,Comedy","Dec 15, 2017",111000000,84410380,289847930,178847930
277,tt1499658,Horrible Bosses,98.0,"Comedy,Crime","Jul 8, 2011",35000000,117538559,212417601,177417601
285,tt5033998,Charlie's Angels,,"Action,Adventure,Comedy","Nov 3, 2000",90000000,125305545,259736090,169736090
289,tt1489889,Central Intelligence,107.0,"Action,Comedy,Crime","Jun 17, 2016",50000000,127440871,217194805,167194805
290,tt2191701,Grown Ups 2,101.0,Comedy,"Jul 12, 2013",80000000,133668525,247023808,167023808
291,tt4877122,The Emoji Movie,86.0,"Adventure,Animation,Comedy","Jul 28, 2017",50000000,86089513,216562312,166562312
292,tt3837024,Aliens,88.0,"Comedy,Mystery,Sci-Fi","Jul 18, 1986",17000000,85160248,183316455,166316455
295,tt0817230,Valentine's Day,125.0,"Comedy,Romance","Feb 12, 2010",52000000,110485654,217569328,165569328
298,tt1915581,Magic Mike,110.0,"Comedy,Drama","Jun 29, 2012",7000000,113721571,170549753,163549753
301,tt1620981,The Addams Family,,"Animation,Comedy,Family","Nov 22, 1991",30000000,113502246,191502246,161502246
304,tt4651520,Bad Moms,100.0,Comedy,"Jul 29, 2016",20000000,113257297,180998716,160998716
305,tt1232829,21 Jump Street,109.0,"Action,Comedy,Crime","Mar 16, 2012",42000000,138447667,202812429,160812429
308,tt2974918,Alvin and the Chipmunks: The Road Chip,92.0,"Adventure,Animation,Comedy","Dec 18, 2015",90000000,85886987,249517956,159517956
311,tt2361509,The Intern,121.0,"Comedy,Drama","Sep 25, 2015",40000000,75764672,197115710,157115710
312,tt2191715,Into the Woods,,"Comedy,Musical","Dec 25, 2014",56200000,128002372,213116401,156916401
319,tt2203939,The Other Woman,109.0,"Comedy,Romance","Apr 25, 2014",40000000,83911193,195111193,155111193
321,tt1664775,Pixels,100.0,"Action,Comedy","Jul 24, 2015",90000000,78765986,244041804,154041804
323,tt1860353,Turbo,96.0,"Adventure,Animation,Comedy","Jul 17, 2013",135000000,83028130,286896578,151896578
324,tt1116184,Jackass 3D,95.0,"Action,Comedy,Documentary","Oct 15, 2010",20000000,117229692,171685793,151685793
325,tt2452042,The Peanuts Movie,88.0,"Adventure,Animation,Comedy","Nov 6, 2015",99000000,130178411,250091610,151091610
329,tt2637276,Ted 2,115.0,Comedy,"Jun 26, 2015",68000000,81476385,217214143,149214143
333,tt1231583,Due Date,95.0,"Adventure,Comedy","Nov 5, 2010",65000000,100539043,211739043,146739043
335,tt1979388,The Good Dinosaur,93.0,"Adventure,Animation,Comedy","Nov 25, 2015",187500000,123087120,333771037,146271037
341,tt1013743,Knight and Day,109.0,"Action,Adventure,Comedy","Jun 23, 2010",117000000,76423035,258751370,141751370
343,tt4765284,Pitch Perfect 3,93.0,"Comedy,Music","Dec 22, 2017",45000000,104897530,185736412,140736412
345,tt2024432,Identity Thief,111.0,"Adventure,Comedy,Crime","Feb 8, 2013",35000000,134506920,175361578,140361578
350,tt2398241,Smurfs: The Lost Village,90.0,"Adventure,Animation,Comedy","Apr 7, 2017",60000000,45020282,197578586,137578586
351,tt2989872,Lion,70.0,"Comedy,Drama,Romance","Nov 25, 2016",12000000,51739495,149570720,137570720
358,tt6182908,Smallfoot,96.0,"Adventure,Animation,Comedy","Sep 28, 2018",80000000,83240103,213691277,133691277
361,tt2278388,The Grand Budapest Hotel,99.0,"Adventure,Comedy,Crime","Mar 7, 2014",31000000,59076019,163981261,132981261
363,tt10340148,Midnight in Paris,75.0,"Comedy,Documentary,Drama","May 20, 2011",30000000,56816662,162502774,132502774
366,tt8633834,The Bucket List,60.0,"Adventure,Comedy","Dec 25, 2007",45000000,93466502,174807445,129807445
380,tt1411704,Hop,95.0,"Adventure,Animation,Comedy","Apr 1, 2011",63000000,108085305,188657593,125657593
382,tt0864835,Mr. Peabody & Sherman,92.0,"Adventure,Animation,Comedy","Mar 7, 2014",145000000,111506430,269806430,124806430
383,tt1302067,Yogi Bear,80.0,"Adventure,Animation,Comedy","Dec 17, 2010",80000000,100246011,204774690,124774690
384,tt1412386,The Best Exotic Marigold Hotel,124.0,"Comedy,Drama,Romance","May 4, 2012",10000000,46383639,134639780,124639780
385,tt1411238,No Strings Attached,108.0,"Comedy,Romance","Jan 21, 2011",25000000,70662220,149228078,124228078
389,tt4575576,Christopher Robin,104.0,"Adventure,Animation,Comedy","Aug 3, 2018",75000000,99215042,197504758,122504758
391,tt1700841,Sausage Party,89.0,"Adventure,Animation,Comedy","Aug 12, 2016",19000000,97670358,141344255,122344255
392,tt1229340,Anchorman 2: The Legend Continues,119.0,Comedy,"Dec 18, 2013",50000000,127352707,172185754,122185754
394,tt0804509,The Mule,100.0,"Comedy,Drama","Dec 14, 2018",50000000,103804407,170857676,120857676
399,tt1320261,Gulliver's Travels,85.0,"Adventure,Comedy,Family","Dec 25, 2010",112000000,42779261,232017848,120017848
401,tt1634122,Johnny English Reborn,101.0,"Action,Adventure,Comedy","Oct 21, 2011",45000000,8406711,164640401,119640401
402,tt0990407,The Green Hornet,119.0,"Action,Comedy,Crime","Jan 14, 2011",110000000,98780042,229155503,119155503
406,tt2096672,Dumb and Dumber To,109.0,"Adventure,Comedy","Nov 14, 2014",40000000,86208010,156553592,116553592
407,tt1204342,The Muppets,103.0,"Adventure,Comedy,Family","Nov 23, 2011",45000000,88625922,160971922,115971922
408,tt1469304,Baywatch,116.0,"Action,Comedy,Crime","May 25, 2017",60000000,58060186,175863783,115863783
410,tt1645170,The Dictator,83.0,Comedy,"May 16, 2012",65000000,59650222,180148897,115148897
416,tt4624424,Storks,87.0,"Adventure,Animation,Comedy","Sep 23, 2016",70000000,72679278,183353431,113353431
418,tt3564472,Girls Trip,122.0,"Comedy,Drama","Jul 21, 2017",28000000,115108515,140886353,112886353
421,tt6498340,End of Days,72.0,"Comedy,Documentary,Drama","Nov 24, 1999",100000000,66889043,212026975,112026975
425,tt1632708,Friends with Benefits,109.0,"Comedy,Romance","Jul 22, 2011",35000000,55802754,146595891,111595891
428,tt1192628,Rango,107.0,"Adventure,Animation,Comedy","Mar 4, 2011",135000000,123477607,245724600,110724600
429,tt3949660,Teenage Mutant Ninja Turtles: Out of the Shadows,112.0,"Action,Adventure,Comedy","Jun 3, 2016",135000000,82051601,245328374,110328374
432,tt2268016,Magic Mike XXL,115.0,"Comedy,Drama,Music","Jul 1, 2015",14500000,66013057,123660597,109160597
433,tt3863552,Bajrangi Bhaijaan,163.0,"Action,Comedy,Drama","Jul 17, 2015",13000000,8178001,121778347,108778347
438,tt3152624,Trainwreck,125.0,"Comedy,Drama,Romance","Jul 17, 2015",35000000,110212700,141123897,106123897
442,tt1596363,The Big Short,130.0,"Biography,Comedy,Drama","Dec 11, 2015",28000000,70259870,133162752,105162752
443,tt4085696,Billy Elliot,169.0,"Comedy,Drama,Music","Oct 13, 2000",5000000,21995263,109253745,104253745
446,tt1535438,Hope Springs,100.0,"Comedy,Drama,Romance","Aug 8, 2012",30000000,63536011,133085295,103085295
447,tt2381941,Focus,105.0,"Comedy,Crime,Drama","Feb 27, 2015",65000000,53862963,168065700,103065700
453,tt1621045,Think Like a Man,122.0,"Comedy,Romance","Apr 20, 2012",12000000,91547205,113373764,101373764
454,tt1051904,Goosebumps,103.0,"Adventure,Comedy,Family","Oct 16, 2015",58000000,80069458,158905324,100905324
458,tt6359956,A Bad Moms Christmas,104.0,"Adventure,Comedy","Nov 1, 2017",28000000,72110659,127710550,99710550
459,tt4653310,Driving Miss Daisy,100.0,"Comedy,Drama","Dec 13, 1989",7500000,106593296,106593296,99093296
460,tt1981677,Pitch Perfect,112.0,"Comedy,Music,Romance","Sep 28, 2012",17000000,65001093,116044347,99044347
462,tt5457656,Hide and Seek,118.0,"Comedy,Crime","Jan 28, 2005",25000000,51100486,123696741,98696741
466,tt1279935,Date Night,88.0,"Comedy,Crime,Romance","Apr 9, 2010",55000000,98711404,152269033,97269033
467,tt0359950,The Secret Life of Walter Mitty,114.0,"Adventure,Comedy,Drama","Dec 25, 2013",91000000,58236838,187861183,96861183
468,tt1047540,Parental Guidance,105.0,"Comedy,Family","Dec 25, 2012",25000000,77267296,120832383,95832383
470,tt1605776,The Visit,90.0,"Comedy,Drama,Romance","Sep 11, 2015",5000000,65206105,98677816,93677816
471,tt1860213,Dirty Grandpa,102.0,Comedy,"Jan 22, 2016",11500000,35593113,105078449,93578449
473,tt1821658,The Nut Job,85.0,"Adventure,Animation,Comedy","Jan 17, 2014",30000000,64251538,122529966,92529966
477,tt1596350,This Means War,103.0,"Action,Comedy,Romance","Feb 17, 2012",65000000,54760791,156974557,91974557
478,tt2321661,Truth or Dare,100.0,"Comedy,Romance","Apr 13, 2018",3500000,41411015,95127344,91627344
480,tt1038919,The Bounty Hunter,110.0,"Action,Comedy,Romance","Mar 19, 2010",45000000,67061228,135808837,90808837
481,tt1222817,Zookeeper,102.0,"Comedy,Family,Romance","Jul 8, 2011",80000000,80360866,170805525,90805525
484,tt2177771,The Monuments Men,118.0,"Comedy,Drama,History","Feb 7, 2014",70000000,78031620,158702748,88702748
485,tt1667353,Mirror Mirror,106.0,"Adventure,Comedy,Drama","Mar 30, 2012",85000000,64935167,173613482,88613482
486,tt2091256,Captain Underpants: The First Epic Movie,89.0,"Action,Animation,Comedy","Jun 2, 2017",38000000,73921000,126577874,88577874
490,tt1077368,Dark Shadows,113.0,"Comedy,Fantasy,Horror","May 11, 2012",150000000,79727149,238202668,88202668
492,tt2431286,Philomena,98.0,"Biography,Comedy,Drama","Nov 22, 2013",12000000,37709979,98963392,86963392
495,tt1956620,Sex Tape,94.0,"Comedy,Romance","Jul 18, 2014",40000000,38543473,126069509,86069509
500,tt3532216,American Made,115.0,"Action,Biography,Comedy","Sep 29, 2017",50000000,51342000,135569212,85569212
501,tt2562232,Birdman or (The Unexpected Virtue of Ignorance),119.0,"Comedy,Drama","Oct 17, 2014",18000000,42340598,103215094,85215094
502,tt3833460,Bride Wars,90.0,Comedy,"Jan 9, 2009",30000000,58715510,115150424,85150424
503,tt1588173,Warm Bodies,98.0,"Comedy,Horror,Romance","Feb 1, 2013",30000000,66380662,115121608,85121608
504,tt1204975,Last Vegas,105.0,"Comedy,Drama","Jan 28, 2013",28000000,63914167,112914167,84914167
506,tt2869728,Ride Along 2,102.0,"Action,Comedy,Crime","Jan 15, 2016",40000000,90862685,124827316,84827316
510,tt1086772,Blended,117.0,"Comedy,Romance","May 23, 2014",45000000,46290741,127990741,82990741
512,tt6112220,The Butterfly Effect,85.0,"Comedy,Crime,Drama","Jan 23, 2004",13000000,57924679,95638592,82638592
515,tt1987680,The Upside,126.0,"Comedy,Drama","Jan 11, 2019",37500000,108235497,119024536,81524536
517,tt1430626,The Pirates! Band of Misfits,88.0,"Adventure,Animation,Comedy","Apr 27, 2012",55000000,31051126,136143605,81143605
518,tt6857166,Book Club,104.0,"Comedy,Drama,Romance","May 18, 2018",10000000,68566296,91113683,81113683
521,tt2555736,The Second Best Exotic Marigold Hotel,122.0,"Comedy,Drama","Mar 6, 2015",10000000,33078266,90384306,80384306
522,tt2704998,Game Night,100.0,"Action,Comedy,Crime","Feb 23, 2018",37000000,69179066,117378084,80378084
523,tt2140373,Saving Mr. Banks,125.0,"Biography,Comedy,Drama","Dec 13, 2013",35000000,83299761,114962525,79962525
524,tt4501244,Why Him?,111.0,Comedy,"Dec 23, 2016",38000000,60323786,117425156,79425156
534,tt7040874,A Simple Favor,117.0,"Comedy,Crime,Drama","Sep 14, 2018",20000000,53548586,97628717,77628717
537,tt2194499,About Time,123.0,"Comedy,Drama,Fantasy","Nov 1, 2013",12000000,15323921,89309178,77309178
540,tt2103254,Tammy,97.0,"Comedy,Romance","Jul 2, 2014",20000000,84525432,96407655,76407655
545,tt7693920,Annie,,"Comedy,Musical","Dec 19, 2014",65000000,85911262,139829625,74829625
547,tt3760922,My Big Fat Greek Wedding 2,94.0,"Comedy,Romance","Mar 25, 2016",18000000,59689605,92096558,74096558
549,tt6781982,Night School,111.0,Comedy,"Sep 28, 2018",29000000,77339130,103008792,74008792
550,tt4438848,Neighbors 2: Sorority Rising,92.0,Comedy,"May 20, 2016",35000000,55340730,108757621,73757621
552,tt3622592,Paper Towns,109.0,"Comedy,Drama,Mystery","Jul 24, 2015",12000000,32000304,85450484,73450484
554,tt1698641,"Alexander and the Terrible, Horrible, No Good, Very Bad Day",81.0,"Comedy,Family","Oct 10, 2014",28000000,66954149,101379287,73379287
555,tt1563742,Overboard,112.0,"Comedy,Romance","May 4, 2018",12000000,50316123,85369830,73369830
557,tt2531344,Blockers,102.0,Comedy,"Apr 6, 2018",21000000,60311495,94045328,73045328
559,tt7368554,The Interpreter,113.0,"Comedy,Drama","Apr 22, 2005",90000000,72708161,162753837,72753837
563,tt2980648,The Hundred-Foot Journey,122.0,"Comedy,Drama","Aug 8, 2014",22000000,54235441,94270488,72270488
565,tt1068242,Footloose,113.0,"Comedy,Drama,Music","Feb 17, 1984",8200000,80000000,80000000,71800000
566,tt7401588,Instant Family,118.0,"Comedy,Drama","Nov 16, 2018",48000000,67363237,119736188,71736188
568,tt0810913,Jack and Jill,91.0,Comedy,"Nov 11, 2011",79000000,74158157,150519217,71519217
569,tt1272878,2 Guns,109.0,"Action,Comedy,Crime","Aug 2, 2013",61000000,75612460,132493015,71493015
572,tt1524930,Vacation,99.0,"Adventure,Comedy","Jul 29, 2015",31000000,58884188,102306500,71306500
574,tt1386588,The Other Guys,107.0,"Action,Comedy,Crime","Aug 6, 2010",100000000,119219978,170936470,70936470
581,tt3450650,Paul Blart: Mall Cop 2,94.0,"Action,Comedy,Crime","Apr 17, 2015",38000000,71091594,107650646,69650646
582,tt1250777,Kick-Ass,117.0,"Action,Comedy","Apr 16, 2010",28000000,48071303,97531134,69531134
585,tt1389137,We Bought a Zoo,124.0,"Comedy,Drama,Family","Dec 23, 2011",50000000,75624550,118729073,68729073
586,tt4925292,Lady Bird,94.0,"Comedy,Drama","Nov 3, 2017",10000000,48958273,78610769,68610769
589,tt1282140,Easy A,92.0,"Comedy,Drama,Romance","Sep 17, 2010",8000000,58401464,76200721,68200721
591,tt1055292,Life as We Know It,114.0,"Comedy,Drama,Romance","Oct 8, 2010",38000000,53374681,105887837,67887837
602,tt8672656,Get Hard,90.0,Comedy,"Mar 27, 2015",40000000,90411453,106511453,66511453
608,tt2170439,Horrible Bosses 2,108.0,"Comedy,Crime","Nov 26, 2014",40000000,54445357,105945357,65945357
609,tt0471042,Tower Heist,104.0,"Action,Comedy,Crime","Nov 4, 2011",85000000,78046570,150422946,65422946
610,tt1430607,Arthur Christmas,97.0,"Adventure,Animation,Comedy","Nov 23, 2011",85000000,46462469,149717124,64717124
611,tt3107798,Rambo,144.0,"Comedy,Drama,Thriller","Jan 25, 2008",47500000,42754105,112214531,64714531
622,tt1196141,Diary of a Wimpy Kid,94.0,"Comedy,Drama,Family","Mar 19, 2010",15000000,64003625,76954311,61954311
623,tt1666186,Vampires Suck,82.0,Comedy,"Aug 18, 2010",20000000,36661504,81424988,61424988
625,tt1092026,Paul,104.0,"Adventure,Comedy,Sci-Fi","Mar 18, 2011",40000000,37412945,101162106,61162106
630,tt1987632,Rush,87.0,"Comedy,Romance","Sep 20, 2013",38000000,26947624,98230839,60230839
634,tt0464154,Piranha 3D,88.0,"Comedy,Horror","Aug 20, 2010",24000000,25003155,83660160,59660160
636,tt6791096,I Feel Pretty,110.0,"Comedy,Romance","Apr 20, 2018",32000000,48795601,91553797,59553797
645,tt5664636,Goosebumps 2: Haunted Halloween,90.0,"Adventure,Comedy,Family","Oct 12, 2018",35000000,46697321,93291478,58291478
653,tt1821694,RED 2,116.0,"Action,Comedy,Crime","Jul 19, 2013",84000000,53262560,141507355,57507355
654,tt2243537,A Haunted House,86.0,"Comedy,Fantasy","Jan 11, 2013",2500000,40041683,59922558,57422558
655,tt0884732,The Wedding Ringer,101.0,Comedy,"Jan 16, 2015",23000000,64460211,80171596,57171596
663,tt2083355,The Best Man Holiday,123.0,"Comedy,Drama","Nov 15, 2013",17000000,70525195,72835710,55835710
664,tt1650043,Diary of a Wimpy Kid: Rodrick Rules,99.0,"Comedy,Family","Mar 25, 2011",18000000,52698535,73695194,55695194
666,tt5164432,"Love, Simon",110.0,"Comedy,Drama,Romance","Mar 16, 2018",10000000,40826341,65520633,55520633
668,tt1621039,Free Birds,91.0,"Adventure,Animation,Comedy","Nov 1, 2013",55000000,55750480,110387072,55387072
669,tt1980209,Pain & Gain,129.0,"Action,Comedy,Crime","Apr 26, 2013",26000000,49875291,81275291,55275291
670,tt2023453,Diary of a Wimpy Kid: Dog Days,94.0,"Comedy,Family","Aug 3, 2012",22000000,49008662,77229695,55229695
674,tt2568862,Going in Style,96.0,"Comedy,Crime","Apr 7, 2017",24000000,45018541,78672579,54672579
677,tt4463894,Shaft,,"Action,Comedy,Crime","Jun 16, 2000",53012938,70327868,107190108,54177170
685,tt1748122,Moonrise Kingdom,94.0,"Adventure,Comedy,Drama","May 25, 2012",16000000,45512466,68848446,52848446
686,tt1859650,To Rome with Love,112.0,"Comedy,Music,Romance","Jun 22, 2012",21500000,16684352,74326015,52826015
688,tt4795124,How to Be a Latin Lover,115.0,"Comedy,Drama","Apr 28, 2017",10000000,32149404,62556228,52556228
690,tt0892318,Letters to Juliet,105.0,"Adventure,Comedy,Drama","May 14, 2010",30000000,53032453,82148538,52148538
691,tt0787474,The Boxtrolls,96.0,"Adventure,Animation,Comedy","Sep 26, 2014",60000000,50837305,111946251,51946251
695,tt1226229,Get Him to the Greek,109.0,"Adventure,Comedy,Music","Jun 4, 2010",40000000,61153526,91455875,51455875
698,tt1586265,What to Expect When You're Expecting,110.0,"Comedy,Drama,Romance","May 18, 2012",37500000,41152203,88473016,50973016
701,tt1464174,"Big Mommas: Like Father, Like Son",107.0,"Action,Comedy,Crime","Feb 18, 2011",32000000,37915414,82332450,50332450
703,tt7634968,What Men Want,117.0,"Comedy,Fantasy,Romance","Feb 8, 2019",20000000,54611903,69911903,49911903
706,tt2702724,The Boss,99.0,Comedy,"Apr 8, 2016",29000000,63077560,78652207,49652207
713,tt5462602,The Big Sick,120.0,"Comedy,Drama,Romance","Jun 23, 2017",5000000,42872467,53972860,48972860
716,tt2387559,Delivery Man,105.0,"Comedy,Drama","Nov 22, 2013",22000000,30659817,70536870,48536870
717,tt1623288,ParaNorman,92.0,"Adventure,Animation,Comedy","Aug 17, 2012",60000000,56003051,108119662,48119662
723,tt2126357,Second Act,103.0,"Comedy,Drama,Romance","Dec 21, 2018",15700000,39282227,63288854,47588854
728,tt3850590,Krampus,98.0,"Comedy,Fantasy,Horror","Dec 4, 2015",15000000,42725475,61788393,46788393
731,tt1711525,Office Christmas Party,105.0,Comedy,"Dec 9, 2016",45000000,54767494,91323299,46323299
735,tt2239832,Think Like a Man Too,106.0,"Comedy,Romance","Jun 20, 2014",24000000,65028687,70027933,46027933
741,tt1441951,Quartet,94.0,"Comedy,Drama","Jan 11, 2013",11000000,18388357,56178935,45178935
743,tt1800246,That Awkward Moment,94.0,"Comedy,Romance","Jan 31, 2014",8000000,26068955,53068955,45068955
752,tt2823054,Mike and Dave Need Wedding Dates,98.0,"Adventure,Comedy,Romance","Jul 8, 2016",33000000,46009673,75898100,42898100
753,tt5580036,"I, Tonya",120.0,"Biography,Comedy,Drama","Dec 8, 2017",11000000,30014534,53797409,42797409
754,tt4587656,The Star,86.0,"Adventure,Animation,Comedy","Nov 17, 2017",20000000,40847995,62758010,42758010
756,tt2178470,Yeh Jawaani Hai Deewani,160.0,"Comedy,Drama,Musical","May 31, 2013",8300000,3827466,50827466,42527466
760,tt0475290,"Hail, Caesar!",106.0,"Comedy,Drama,Music","Feb 5, 2016",22000000,30080225,64160680,42160680
761,tt1142977,Frankenweenie,87.0,"Animation,Comedy,Family","Oct 5, 2012",39000000,35287788,81150788,42150788
762,tt2170593,St. Vincent,102.0,"Comedy,Drama","Oct 10, 2014",13000000,44137712,54837234,41837234
775,tt1391137,Why Did I Get Married Too?,121.0,"Comedy,Drama,Romance","Apr 2, 2010",20000000,60095852,60831067,40831067
777,tt4999290,Remember Me,,"Comedy,Drama,Romance","Mar 12, 2010",16000000,19068240,56506120,40506120
779,tt1212436,The Back-up Plan,104.0,"Comedy,Romance","Apr 23, 2010",35000000,37490007,75281179,40281179
781,tt1392197,Marmaduke,87.0,"Comedy,Family","Jun 4, 2010",50000000,33644788,89895930,39895930
791,tt2458724,Little Man,,Comedy,"Jul 14, 2006",64000000,58636047,101636047,37636047
794,tt1826590,About Last Night,100.0,"Comedy,Romance","Feb 14, 2014",13000000,48637684,50445860,37445860
810,tt3722070,The Lady in the Van,104.0,"Biography,Comedy,Drama","Jan 15, 2016",6000000,10021175,42320503,36320503
811,tt2005151,War Dogs,114.0,"Comedy,Crime,Drama","Aug 19, 2016",50000000,43034523,86234503,36234503
813,tt2229499,Don Jon,90.0,"Comedy,Drama,Romance","Sep 27, 2013",5500000,24477704,41268579,35768579
814,tt1826727,Life of the Party,84.0,"Comedy,Drama","May 11, 2018",30000000,53059911,65759911,35759911
815,tt2234155,The Internship,119.0,Comedy,"Jun 7, 2013",58000000,44672764,93672764,35672764
824,tt1650554,Kick-Ass 2,103.0,"Action,Comedy,Crime","Aug 16, 2013",28000000,28795985,63129909,35129909
829,tt3628584,Barbershop: The Next Cut,111.0,"Comedy,Drama","Apr 15, 2016",20000000,54030051,54404202,34404202
830,tt5138210,Good Luck Chuck,51.0,Comedy,"Sep 21, 2007",25000000,35017297,59183821,34183821
837,tt5113040,The Secret Life of Pets 2,86.0,"Adventure,Animation,Comedy","Jun 7, 2019",80000000,63795655,113351496,33351496
842,tt0842926,The Kids Are All Right,106.0,"Comedy,Drama,Romance","Jul 9, 2010",4000000,20811365,36275469,32275469
843,tt3099638,Barfi,105.0,"Comedy,Romance","Sep 14, 2012",4600000,2804874,36751984,32151984
846,tt1195478,The Five-Year Engagement,124.0,"Comedy,Romance","Apr 27, 2012",30000000,28700285,61623819,31623819
847,tt1583420,Larry Crowne,98.0,"Comedy,Drama,Romance","Jul 1, 2011",30000000,35608245,61449135,31449135
849,tt1648179,Here Comes the Boom,105.0,"Action,Comedy,Sport","Oct 12, 2012",42000000,45290318,73239258,31239258
851,tt1640484,Jumping the Broom,112.0,"Comedy,Drama","May 6, 2011",7000000,37295394,38158601,31158601
855,tt0889573,The Switch,101.0,"Comedy,Drama,Romance","Aug 20, 2010",19000000,27758465,49858465,30858465
860,tt4876464,Rosemary's Baby,48.0,Comedy,"Jun 12, 1968",3200000,33395426,33395426,30195426
861,tt7186036,Volcano,104.0,"Comedy,Drama","Apr 25, 1997",90000000,47546796,120100000,30100000
862,tt0491152,Something Borrowed,112.0,"Comedy,Drama,Romance","May 6, 2011",35000000,39046489,65084116,30084116
864,tt1231587,Hot Tub Time Machine,101.0,"Comedy,Sci-Fi","Mar 26, 2010",36000000,50269859,65967750,29967750
867,tt2609912,Kevin Hart: Let Me Explain,75.0,"Comedy,Documentary","Jul 3, 2013",2500000,32244051,32327255,29827255
868,tt1661382,Grudge Match,113.0,"Comedy,Drama,Sport","Dec 25, 2013",40000000,29807260,69807260,29807260
874,tt1787759,Madea's Big Happy Family,106.0,"Comedy,Drama","Apr 22, 2011",25000000,53345287,54160818,29160818
877,tt1178665,A Walk in the Woods,104.0,"Adventure,Biography,Comedy","Sep 2, 2015",8000000,29499394,37119358,29119358
883,tt0815236,She's Out of My League,104.0,"Comedy,Romance","Mar 12, 2010",20000000,32010860,48680977,28680977
885,tt3148834,Thunder and the House of Magic,85.0,"Adventure,Animation,Comedy","Sep 5, 2014",34000000,4091,62582520,28582520
886,tt2296777,Sherlock Gnomes,86.0,"Adventure,Animation,Comedy","Mar 23, 2018",59000000,43242871,87527651,28527651
887,tt7334528,Uncle Drew,103.0,"Comedy,Sport","Jun 29, 2018",18000000,42469946,46527161,28527161
891,tt1287468,Cats & Dogs: The Revenge of Kitty Galore,82.0,"Action,Comedy,Family","Jul 30, 2010",85000000,43585753,113026383,28026383
893,tt1321509,Death at a Funeral,92.0,Comedy,"Apr 16, 2010",21000000,42739347,48977233,27977233
896,tt1213663,The World's End,109.0,"Action,Comedy,Sci-Fi","Aug 23, 2013",20000000,26004851,47508505,27508505
899,tt4136084,Florence Foster Jenkins,111.0,"Biography,Comedy,Drama","Aug 12, 2016",29000000,27383770,56000339,27000339
900,tt4799050,Rough Night,101.0,"Comedy,Crime,Thriller","Jun 16, 2017",20000000,22105643,46844357,26844357
907,tt2101441,Spring Breakers,94.0,"Comedy,Crime,Drama","Mar 15, 2013",5000000,14124286,31149251,26149251
910,tt1853739,You're Next,95.0,"Action,Comedy,Horror","Aug 23, 2013",1000000,18494006,26887177,25887177
912,tt1322269,August: Osage County,121.0,"Comedy,Drama","Dec 25, 2013",25000000,37738810,50738810,25738810
914,tt4649416,Almost Christmas,111.0,"Comedy,Drama","Nov 11, 2016",17000000,42065185,42493506,25493506
928,tt2281587,Muppets Most Wanted,107.0,"Adventure,Comedy,Crime","Mar 21, 2014",55000000,51178893,79312301,24312301
931,tt2279339,Love the Coopers,107.0,"Comedy,Fantasy,Romance","Nov 13, 2015",18000000,26302731,42227490,24227490
936,tt1488555,The Change-Up,112.0,"Comedy,Fantasy","Aug 5, 2011",52000000,37243418,75997067,23997067
942,tt1830712,Max,52.0,"Biography,Comedy,Documentary","Jun 26, 2015",20000000,42656255,43658157,23658157
945,tt3623726,Ricki and the Flash,101.0,"Comedy,Drama,Music","Aug 7, 2015",18000000,26839498,41166033,23166033
947,tt1402488,Happy Feet Two,100.0,"Adventure,Animation,Comedy","Nov 18, 2011",135000000,64006466,157956466,22956466
956,tt4203258,The Reaping,84.0,"Comedy,Horror,Thriller","Apr 5, 2007",40000000,25126214,62226214,22226214
957,tt6175394,Posledniy bogatyr,114.0,"Action,Adventure,Comedy","Dec 31, 2017",8500000,0,30700192,22200192
958,tt1083452,Eddie the Eagle,106.0,"Biography,Comedy,Drama","Feb 26, 2016",23000000,15789389,45060480,22060480
960,tt6179182,New in Town,95.0,"Adventure,Comedy,Fantasy","Jan 30, 2009",8000000,16734283,29937909,21937909
961,tt1727388,The Way Way Back,103.0,"Comedy,Drama","Jul 5, 2013",5000000,21502690,26853810,21853810
967,tt3979452,The Best Years of Our Lives,,Comedy,"Nov 21, 1946",2100000,23600000,23600000,21500000
970,tt4698684,Hunt for the Wilderpeople,101.0,"Adventure,Comedy,Drama","Jun 24, 2016",2500000,5205471,23845533,21345533
972,tt1333125,Movie 43,94.0,Comedy,"Jan 25, 2013",10000000,8840453,31164747,21164747
979,tt1637706,Our Idiot Brother,90.0,"Comedy,Drama","Aug 26, 2011",5000000,24814830,25861249,20861249
985,tt8653640,An Ideal Husband,,Comedy,"Jun 18, 1999",10700000,18542974,31341183,20641183
986,tt1103153,Killers,100.0,"Action,Comedy,Romance","Jun 4, 2010",75000000,47059963,95572749,20572749
991,tt1449283,Winnie the Pooh,63.0,"Adventure,Animation,Comedy","Jul 15, 2011",30000000,26692846,50145607,20145607
997,tt1126618,Morning Glory,107.0,"Comedy,Drama,Romance","Nov 10, 2010",40000000,31011732,59795070,19795070
998,tt1067774,Monte Carlo,109.0,"Adventure,Comedy,Family","Jul 1, 2011",20000000,23186769,39686769,19686769
1000,tt1931533,Seven Psychopaths,110.0,"Comedy,Crime","Oct 12, 2012",13500000,15024049,33035736,19535736
1003,tt1182350,You Will Meet a Tall Dark Stranger,98.0,"Comedy,Drama,Romance","Sep 22, 2010",15000000,3247816,34247816,19247816
1004,tt0480687,Hall Pass,105.0,"Comedy,Romance","Feb 25, 2011",68000000,45060734,87173475,19173475
1007,tt1385867,Cop Out,107.0,"Action,Comedy,Crime","Feb 26, 2010",37000000,44875481,55909910,18909910
1008,tt1273678,The Spy Next Door,94.0,"Action,Comedy,Family","Jan 15, 2010",28000000,24307106,46752858,18752858
1010,tt3521126,The Disaster Artist,104.0,"Biography,Comedy,Drama","Dec 1, 2017",10000000,21120616,28717667,18717667
1013,tt5719388,9,,Comedy,"Sep 9, 2009",30000000,31749894,48559999,18559999
1019,tt8008626,Love Happens,,"Comedy,Horror,Romance","Sep 18, 2009",18000000,22965110,36133014,18133014
1022,tt0427152,Dinner for Schmucks,114.0,Comedy,"Jul 30, 2010",69000000,73026337,86796502,17796502
1024,tt2390361,Enough Said,93.0,"Comedy,Drama,Romance","Sep 18, 2013",8000000,17550872,25621449,17621449
1026,tt3486626,The Nut Job 2: Nutty by Nature,91.0,"Adventure,Animation,Comedy","Aug 11, 2017",40000000,28370522,57438389,17438389
1030,tt2828996,A Haunted House 2,86.0,"Comedy,Fantasy","Apr 18, 2014",4000000,17329487,21206861,17206861
1031,tt4667094,Fifty Shades of Black,92.0,Comedy,"Jan 29, 2016",5000000,11686940,22113075,17113075
1036,tt4607118,Burnt,,"Comedy,Drama","Oct 30, 2015",20000000,13651946,36773510,16773510
1039,tt1674771,Entourage,104.0,Comedy,"Jun 3, 2015",30000000,32363404,46438538,16438538
1043,tt1268799,A Very Harold & Kumar 3D Christmas,90.0,"Adventure,Comedy","Nov 4, 2011",20000000,35061031,36265745,16265745
1046,tt1931435,The Big Wedding,89.0,"Comedy,Drama,Romance","Apr 26, 2013",32500000,21819348,48425971,15925971
1047,tt5748648,The Bachelor,,"Comedy,Romance","Nov 5, 1999",21000000,21731001,36882378,15882378
1056,tt3401882,Fist Fight,91.0,Comedy,"Feb 17, 2017",25000000,32187017,40286416,15286416
1057,tt5439796,Logan Lucky,118.0,"Comedy,Crime,Drama","Aug 18, 2017",29000000,27778642,44264271,15264271
1058,tt1462769,The Odd Life of Timothy Green,105.0,"Comedy,Drama,Family","Aug 15, 2012",40000000,51853450,55249159,15249159
1059,tt1540133,The Guard,96.0,"Comedy,Crime,Thriller","Jul 29, 2011",6000000,5359774,21197454,15197454
1062,tt6428676,Wonder Park,85.0,"Adventure,Animation,Comedy","Mar 15, 2019",100000000,45216793,115149422,15149422
1064,tt5688932,Sorry to Bother You,111.0,"Comedy,Fantasy,Sci-Fi","Jul 6, 2018",3200000,17493096,18285560,15085560
1066,tt4981636,Middle School: The Worst Years of My Life,92.0,"Comedy,Family","Oct 7, 2016",8500000,20007149,23311293,14811293
1073,tt2651158,Much Ado About Nothing,167.0,"Comedy,Drama","May 7, 1993",8000000,22549338,22549338,14549338
1075,tt1488181,Zambezia,83.0,"Adventure,Animation,Comedy","Dec 31, 2012",20000000,0,34454336,14454336
1076,tt1171222,Baggage Claim,96.0,Comedy,"Sep 27, 2013",8500000,21569509,22885836,14385836
1082,tt2784678,Top Five,102.0,"Comedy,Romance","Dec 12, 2014",12000000,25317379,26001741,14001741
1091,tt1366344,The Sitter,81.0,Comedy,"Dec 9, 2011",25000000,30542576,38749404,13749404
1095,tt6003368,Diary of a Wimpy Kid: The Long Haul,91.0,"Comedy,Family","May 19, 2017",22000000,20738724,35609577,13609577
1096,tt4669186,Kevin Hart: What Now?,96.0,"Comedy,Documentary","Oct 14, 2016",10000000,23591043,23591043,13591043
1099,tt3464902,The Lobster,119.0,"Comedy,Drama,Romance","Mar 25, 2016",4500000,9196278,18019834,13519834
1104,tt6667360,Carnage,68.0,Comedy,"Dec 16, 2011",25000000,2546747,38112154,13112154
1108,tt1622547,30 Minutes or Less,83.0,"Action,Comedy,Crime","Aug 12, 2011",28000000,37053924,40966716,12966716
1111,tt1414382,You Again,105.0,"Comedy,Family,Romance","Sep 24, 2010",20000000,25702053,32838945,12838945
1113,tt1821549,Nebraska,115.0,"Adventure,Comedy,Drama","Nov 15, 2013",12000000,17654912,24761360,12761360
1120,tt1594972,Norm of the North,90.0,"Adventure,Animation,Comedy","Jan 15, 2016",18000000,17062499,30535660,12535660
1122,tt0493949,Ramona and Beezus,103.0,"Adventure,Comedy,Family","Jul 23, 2010",15000000,26167002,27469621,12469621
1124,tt7014006,Eighth Grade,93.0,"Comedy,Drama","Jul 13, 2018",2000000,13539710,14341016,12341016
1125,tt2910904,The Dressmaker,119.0,"Comedy,Drama","Sep 23, 2016",11900000,2022115,24041617,12141617
1126,tt1298649,The Watch,102.0,"Action,Comedy,Horror","Jul 27, 2012",55000000,34353000,67130045,12130045
1129,tt2236686,Copycat,90.0,Comedy,"Oct 27, 1995",20000000,32051917,32051917,12051917
1136,tt5127484,Going the Distance,65.0,Comedy,"Sep 3, 2010",32000000,17804299,43603990,11603990
1140,tt1673697,The Sapphires,103.0,"Biography,Comedy,Drama","Mar 22, 2013",9000000,2450867,20395040,11395040
1141,tt3850214,Dope,103.0,"Comedy,Crime,Drama","Jun 19, 2015",7000000,17506470,18190831,11190831
1143,tt1532503,Beginners,105.0,"Comedy,Drama,Romance","Jun 3, 2011",3200000,5790894,14314407,11114407
1144,tt3312830,Youth,124.0,"Comedy,Drama,Music","Dec 4, 2015",13000000,2703296,24001573,11001573
1147,tt6266538,Vice,132.0,"Biography,Comedy,Drama","Dec 25, 2018",60000000,47836282,70883171,10883171
1149,tt1625346,Young Adult,94.0,"Comedy,Drama","Dec 9, 2011",12000000,16311571,22750356,10750356
1151,tt2967224,Hot Pursuit,87.0,"Action,Comedy,Crime","May 8, 2015",35000000,34580201,45671512,10671512
1153,tt1438176,Fright Night,106.0,"Comedy,Horror","Aug 19, 2011",30000000,18298649,40520649,10520649
1154,tt1866249,The Sessions,95.0,"Biography,Comedy,Drama","Oct 19, 2012",1000000,6002451,11495204,10495204
1160,tt0770703,What's Your Number?,106.0,"Comedy,Romance","Sep 30, 2011",20000000,14011084,30163785,10163785
1161,tt6040918,Just My Luck,,Comedy,"May 12, 2006",28000000,17326650,38159905,10159905
1162,tt1878870,The Edge of Seventeen,104.0,"Comedy,Drama","Nov 18, 2016",9000000,14431633,19096003,10096003
1163,tt1421051,Somewhere,97.0,"Comedy,Drama","Dec 22, 2010",7000000,1785645,17023121,10023121
1169,tt1407061,Just Wright,100.0,"Comedy,Romance,Sport","May 14, 2010",12000000,21540363,21867665,9867665
1172,tt3799694,The Nice Guys,116.0,"Action,Comedy,Crime","May 20, 2016",50000000,36261763,59596747,9596747
1173,tt1920849,Bachelorette,87.0,"Comedy,Romance","Sep 7, 2012",3000000,446770,12577401,9577401
1177,tt3606888,A Street Cat Named Bob,103.0,"Biography,Comedy,Drama","Nov 18, 2016",8000000,82703,17382693,9382693
1183,tt2166214,Khiladi 786,141.0,"Action,Comedy","Dec 7, 2012",5600000,385422,14683763,9083763
1196,tt2347569,Frances Ha,86.0,"Comedy,Drama,Romance","May 17, 2013",3000000,4067398,11262769,8262769
1200,tt4191580,Meet the Blacks,94.0,"Comedy,Horror","Apr 1, 2016",900000,9097072,9097072,8197072
1202,tt1508675,Le Havre,93.0,"Comedy,Drama","Oct 21, 2011",5500000,611709,13480196,7980196
1207,tt1334512,Arthur,110.0,"Comedy,Romance","Apr 8, 2011",40000000,33035397,47787943,7787943
1209,tt0979434,Lottery Ticket,99.0,Comedy,"Aug 20, 2010",17000000,24719879,24719879,7719879
1211,tt1371155,Made in Dagenham,113.0,"Biography,Comedy,Drama","Nov 19, 2010",8000000,1095369,15644196,7644196
1216,tt1791682,While We're Young,97.0,"Comedy,Drama,Mystery","Mar 27, 2015",10000000,7582065,17503828,7503828
1217,tt2879218,The Collector,94.0,"Action,Comedy","Jul 31, 2009",3000000,7712114,10473836,7473836
1218,tt1305583,Our Family Wedding,103.0,"Comedy,Romance","Mar 12, 2010",14000000,20255281,21410546,7410546
1221,tt1999192,Kevin Hart: Laugh at My Pain,89.0,"Comedy,Documentary","Sep 9, 2011",750000,7706436,7712436,6962436
1225,tt7166214,Bobby,142.0,"Comedy,Romance","Nov 17, 2006",14000000,11242801,20597806,6597806
1229,tt10297320,Swingers,,Comedy,"Oct 18, 1996",200000,4505922,6618578,6418578
1239,tt1814621,Admission,107.0,"Comedy,Drama,Romance","Mar 22, 2013",13000000,18007317,18733666,5733666
1240,tt5247022,Paterson,118.0,"Comedy,Drama,Romance","Dec 28, 2016",5000000,2141423,10727536,5727536
1241,tt4139124,Keanu,100.0,"Action,Comedy,Crime","Apr 29, 2016",15000000,20591853,20688141,5688141
1246,tt4080386,Sardaar Ji,141.0,"Comedy,Fantasy,Horror","Dec 31, 2015",2700000,0,8200000,5500000
1250,tt1608290,Zoolander 2,101.0,Comedy,"Feb 12, 2016",50000000,28848693,55348693,5348693
1255,tt4871980,The Perfect Match,96.0,"Comedy,Romance","Mar 11, 2016",5000000,9669521,10182050,5182050
1260,tt1571249,The Skeleton Twins,93.0,"Comedy,Drama,Romance","Sep 12, 2014",1000000,5284309,5797192,4797192
1262,tt6576106,Love Letters,,Comedy,"Apr 27, 1984",550000,5269990,5269990,4719990
1267,tt3367294,Compadres,101.0,"Action,Comedy,Crime","Apr 22, 2016",3000000,3127773,7445044,4445044
1269,tt1714206,The Spectacular Now,95.0,"Comedy,Drama,Romance","Aug 2, 2013",2500000,6852971,6916951,4416951
1273,tt0492389,Furry Vengeance,92.0,"Comedy,Family","Apr 30, 2010",35000000,17630465,39340177,4340177
1281,tt2235108,Dear White People,108.0,"Comedy,Drama,Romance","Oct 17, 2014",1250000,4404154,5403771,4153771
1283,tt1704573,Bernie,99.0,"Biography,Comedy,Crime","Apr 27, 2012",6000000,9204489,10106975,4106975
1292,tt1862079,Safety Not Guaranteed,86.0,"Comedy,Drama,Romance","Jun 8, 2012",750000,4010957,4422318,3672318
1293,tt1710396,Joyful Noise,118.0,"Comedy,Drama,Music","Jan 13, 2012",27500000,30932113,31157914,3657914
1296,tt4621872,Like Crazy,116.0,"Comedy,Drama","Oct 28, 2011",250000,3395391,3728400,3478400
1301,tt8161226,All You Need Is Love,113.0,"Comedy,Romance","Oct 31, 2014",300000,0,3565259,3265259
1306,tt5358844,Head of State,,Comedy,"Mar 28, 2003",35200000,37788228,38283765,3083765
1310,tt1742336,Your Sister's Sister,90.0,"Comedy,Drama","Jun 15, 2012",120000,1597486,3090593,2970593
1311,tt4034354,Swiss Army Man,97.0,"Adventure,Comedy,Drama","Jun 24, 2016",3000000,4210454,5837111,2837111
1313,tt1604171,Prom,104.0,"Comedy,Drama,Family","Apr 29, 2011",8000000,10130219,10763183,2763183
1318,tt1440292,Submarine,97.0,"Comedy,Drama,Romance","Jun 3, 2011",1900000,467602,4581937,2681937
1320,tt3212738,Hostage,97.0,"Comedy,Drama,History","Mar 11, 2005",75000000,34636443,77636443,2636443
1321,tt1758795,The To Do List,104.0,"Comedy,Romance","Jul 26, 2013",1500000,3491669,4128828,2628828
1325,tt1702425,Casa de mi Padre,84.0,"Comedy,Western","Mar 16, 2012",6000000,5909483,8446952,2446952
1326,tt1990314,Robot & Frank,89.0,"Comedy,Crime,Drama","Aug 17, 2012",2500000,3317468,4934356,2434356
1328,tt4501454,The Meddler,103.0,"Comedy,Drama,Romance","Apr 22, 2016",3200000,4267219,5526942,2326942
1329,tt2910274,Obvious Child,84.0,"Comedy,Drama,Romance","Jun 6, 2014",1000000,3122616,3324070,2324070
1330,tt3316948,American Ultra,96.0,"Action,Comedy,Sci-Fi","Aug 21, 2015",28000000,14439985,30295028,2295028
1333,tt1640711,A Few Best Men,97.0,"Comedy,Romance","May 5, 2015",15000000,0,17224539,2224539
1339,tt1307068,Seeking a Friend for the End of the World,101.0,"Adventure,Comedy,Drama","Jun 22, 2012",10000000,7078738,11766959,1766959
1341,tt4595882,Can You Ever Forgive Me?,106.0,"Biography,Comedy,Crime","Oct 19, 2018",10000000,8803865,11752387,1752387
1348,tt0878835,Please Give,87.0,"Comedy,Drama","Apr 30, 2010",3000000,4033574,4570178,1570178
1350,tt3332064,Pan,111.0,"Adventure,Comedy,Family","Oct 9, 2015",150000000,35088320,151525973,1525973
1354,tt1791679,Weekend,121.0,"Action,Comedy,Crime","Sep 23, 2011",190000,484592,1577585,1387585
1357,tt1694020,The Guilt Trip,95.0,"Comedy,Drama","Dec 19, 2012",40000000,37134215,41294674,1294674
1358,tt2582496,Me and Earl and the Dying Girl,105.0,"Comedy,Drama,Romance","Jun 12, 2015",8000000,6758416,9266180,1266180
1371,tt5569344,Tarnation,90.0,"Comedy,Horror","Oct 6, 2004",400000,592014,1162014,762014
1375,tt2870708,Wish I Was Here,106.0,"Comedy,Drama","Jul 18, 2014",6000000,3591299,6591365,591365
1376,tt1232200,That's My Boy,116.0,Comedy,"Jun 15, 2012",57500000,36931089,58085235,585235
1377,tt4543578,Drop Dead Gorgeous,100.0,Comedy,"Jul 23, 1999",10000000,10571408,10571408,571408
1379,tt1727776,Scouts Guide to the Zombie Apocalypse,93.0,"Action,Comedy,Horror","Oct 30, 2015",15000000,3703046,15554855,554855
1380,tt1578275,The Dilemma,111.0,"Comedy,Drama","Jan 14, 2011",70000000,48475290,70546865,546865
1382,tt5822766,Love and Other Catastrophes,100.0,"Comedy,Drama","Mar 28, 1997",250000,212285,743216,493216
1383,tt1742650,I Don't Know How She Does It,89.0,"Comedy,Romance","Sep 16, 2011",24000000,9659074,24474463,474463
1389,tt7158430,Hearts Beat Loud,97.0,"Comedy,Drama,Music","Jun 8, 2018",2000000,2386254,2420962,420962
1391,tt9899880,Columbus,85.0,Comedy,"Aug 4, 2017",700000,1017107,1110511,410511
1393,tt1570989,Tiny Furniture,98.0,"Comedy,Drama,Romance","Nov 12, 2010",50000,391674,424149,374149
1398,tt4902904,The Resurrection of Gavin Stone,91.0,"Comedy,Drama,Family","Jan 20, 2017",2000000,2303792,2303792,303792
1400,tt3172532,The Diary of a Teenage Girl,102.0,"Comedy,Drama,Romance","Aug 7, 2015",2000000,1477002,2279959,279959
1401,tt1500906,Vampires,88.0,"Comedy,Fantasy,Horror","Oct 30, 1998",20000000,20268825,20268825,268825
1410,tt1612774,Rubber,82.0,"Comedy,Fantasy,Horror","Apr 1, 2011",500000,100370,680914,180914
1416,tt6619196,Clean,70.0,"Comedy,Drama,Horror","Apr 28, 2006",10000,138711,138711,128711
1423,tt2404299,Lovesick,85.0,"Comedy,Romance","Feb 18, 1983",10100000,10143618,10143618,43618
1433,tt1880418,Newlyweds,95.0,"Comedy,Drama","Jan 13, 2012",9000,4584,4584,-4416
1437,tt2389182,Cheap Thrills,88.0,"Comedy,Crime,Drama","Mar 21, 2014",100000,59424,59424,-40576
1439,tt1874789,Supporting Characters,87.0,Comedy,"Jan 25, 2013",60000,4917,4917,-55083
1444,tt1255919,Holmes & Watson,90.0,"Adventure,Comedy,Crime","Dec 25, 2018",42000000,30568743,41926605,-73395
1447,tt2465146,And So It Goes,94.0,"Comedy,Drama,Romance","Jul 25, 2014",18000000,15160801,17920013,-79987
1448,tt2265398,Drinking Buddies,90.0,"Comedy,Drama,Romance","Aug 23, 2013",500000,343706,407100,-92900
1455,tt1822311,Sparrows Dance,81.0,"Comedy,Drama,Romance","Aug 23, 2013",175000,2602,2602,-172398
1464,tt2290113,Along the Roadside,108.0,"Comedy,Music,Romance","Mar 24, 2015",250000,0,3234,-246766
1473,tt4320966,Jackpot,92.0,Comedy,"Jul 27, 2001",400000,44452,44452,-355548
1475,tt1412528,Table 19,87.0,"Comedy,Drama,Romance","Mar 3, 2017",5000000,3614896,4620399,-379601
1483,tt1935902,The Brass Teapot,101.0,"Comedy,Fantasy,Thriller","Apr 5, 2013",900000,6997,413733,-486267
1484,tt6906324,American Dreamz,7.0,"Comedy,Documentary","Apr 21, 2006",17000000,7314027,16510971,-489029
1486,tt1865346,Detention of the Dead,87.0,"Action,Adventure,Comedy","Jun 28, 2013",500000,1778,1778,-498222
1493,tt4374230,Julija in alfa Romeo,83.0,Comedy,"Dec 31, 2015",560000,0,8462,-551538
1496,tt1592873,LOL,97.0,"Comedy,Drama,Romance","May 4, 2012",11000000,0,10431506,-568494
1499,tt1950135,Drunk Wedding,81.0,Comedy,"May 22, 2015",600000,3301,3301,-596699
1500,tt1758575,Blue Like Jazz,108.0,"Comedy,Drama","Apr 13, 2012",1200000,595018,595018,-604982
1505,tt5741008,Bully,83.0,Comedy,"Jul 13, 2001",2100000,881824,1381824,-718176
1506,tt2140619,Two Night Stand,86.0,"Comedy,Romance","Sep 26, 2014",1600000,15600,868081,-731919
1509,tt3569356,Not Cool,93.0,"Comedy,Drama,Romance","Sep 19, 2014",800000,35688,35688,-764312
1516,tt1769363,The Giant Mechanical Man,95.0,"Comedy,Drama,Romance","Apr 27, 2012",900000,7396,7396,-892604
1518,tt1726589,L!fe Happens,100.0,Comedy,"Apr 13, 2012",930000,30905,30905,-899095
1526,tt4590482,Karachi se Lahore,143.0,"Adventure,Comedy,Family","Dec 31, 2015",1000000,0,17721,-982279
1527,tt3145220,Hits,96.0,"Comedy,Drama","Feb 13, 2015",1000000,15156,15156,-984844
1528,tt8655470,The Specials,,Comedy,"Sep 22, 2000",1000000,12996,12996,-987004
1531,tt4733536,American Hero,86.0,"Action,Comedy,Drama","Dec 11, 2015",1000000,0,26,-999974
1539,tt3099498,Tusk,102.0,"Comedy,Drama,Horror","Sep 19, 2014",3000000,1821983,1887554,-1112446
1541,tt4995790,The Square,151.0,"Comedy,Drama","Apr 9, 2010",1900000,406216,740932,-1159068
1544,tt2637294,Hot Tub Time Machine 2,93.0,"Comedy,Mystery,Sci-Fi","Feb 20, 2015",14000000,12314651,12826644,-1173356
1550,tt3504048,Housebound,107.0,"Comedy,Horror,Mystery","Oct 17, 2014",1500000,0,236863,-1263137
1553,tt1341167,Four Lions,97.0,"Comedy,Crime,Drama","Nov 5, 2010",3750000,310007,2436111,-1313889
1556,tt1695994,The Virginity Hit,86.0,Comedy,"Sep 24, 2010",2000000,636706,636706,-1363294
1557,tt0804497,It's Kind of a Funny Story,101.0,"Comedy,Drama,Romance","Oct 8, 2010",8000000,6363628,6632950,-1367050
1558,tt1470023,MacGruber,90.0,"Action,Comedy,Romance","May 21, 2010",10000000,8525600,8629895,-1370105
1559,tt3110770,Road Hard,98.0,Comedy,"Mar 6, 2015",1500000,113169,113169,-1386831
1560,tt1480658,Eddie: The Sleepwalking Cannibal,90.0,"Comedy,Horror","Apr 5, 2013",1400000,1632,1632,-1398368
1561,tt8043306,Teefa in Trouble,155.0,"Action,Comedy,Crime","Jul 20, 2018",1500000,0,98806,-1401194
1563,tt2017486,Closer to the Moon,112.0,"Comedy,Crime,Drama","Apr 17, 2014",1500000,0,5396,-1494604
1565,tt1772288,Danny Collins,106.0,"Biography,Comedy,Drama","Mar 20, 2015",10000000,5637066,8465845,-1534155
1571,tt1667307,Damsels in Distress,99.0,"Comedy,Drama,Romance","Apr 6, 2012",3000000,1007535,1324299,-1675701
1572,tt1699755,Peeples,95.0,"Comedy,Romance","May 10, 2013",11000000,9177065,9307166,-1692834
1575,tt2474024,The Last Five Years,94.0,"Comedy,Drama,Musical","Feb 13, 2015",2000000,147299,205298,-1794702
1576,tt5649108,Thoroughbreds,92.0,"Comedy,Crime,Drama","Mar 9, 2018",5000000,3072605,3187302,-1812698
1578,tt3566698,Vaalu,155.0,"Comedy,Romance","Dec 31, 2015",1900000,0,12444,-1887556
1579,tt1512235,Super,96.0,"Action,Comedy,Drama","Apr 1, 2011",2500000,327716,593933,-1906067
1589,tt1754633,The Ghastly Love of Johnny X,106.0,"Comedy,Fantasy,Musical","Oct 26, 2012",2000000,2436,2436,-1997564
1593,tt1477837,Cedar Rapids,87.0,Comedy,"Feb 11, 2011",10000000,6861102,7862131,-2137869
1594,tt2170299,Bad Words,89.0,"Comedy,Drama","Mar 14, 2014",10000000,7779614,7843145,-2156855
1595,tt1640459,Hobo with a Shotgun,86.0,"Action,Comedy,Horror","May 6, 2011",3000000,703372,834953,-2165047
1596,tt1531663,Everything Must Go,97.0,"Comedy,Drama","May 13, 2011",5000000,2712131,2821010,-2178990
1597,tt2690138,The D Train,101.0,"Comedy,Drama","May 8, 2015",3000000,669688,772366,-2227634
1602,tt2401878,Anomalisa,90.0,"Animation,Comedy,Drama","Dec 30, 2015",8000000,3759286,5706168,-2293832
1611,tt0443465,Before We Go,95.0,"Comedy,Drama,Romance","Sep 4, 2015",3000000,37151,483938,-2516062
1613,tt3253232,The Bounce Back,104.0,"Comedy,Romance","Dec 9, 2016",3000000,321910,421404,-2578596
1619,tt1235189,Wild Target,98.0,"Action,Comedy,Crime","Oct 29, 2010",8000000,109338,5314194,-2685806
1624,tt1855401,Tim and Eric's Billion Dollar Movie,93.0,Comedy,"Mar 2, 2012",3000000,201436,223652,-2776348
1626,tt1663143,Fun Size,86.0,"Adventure,Comedy","Oct 26, 2012",14000000,9409538,11166615,-2833385
1631,tt1509803,Griff the Invisible,90.0,"Comedy,Drama,Romance","Aug 19, 2011",2900000,20778,25935,-2874065
1632,tt3859304,The Bronze,100.0,"Comedy,Drama,Sport","Mar 18, 2016",3500000,615816,615816,-2884184
1633,tt2398249,They Came Together,83.0,"Comedy,Romance","Jun 27, 2014",3000000,0,82780,-2917220
1638,tt7844060,Lady in White,98.0,"Comedy,Drama","Apr 22, 1988",4700000,1705139,1705139,-2994861
1640,tt1719071,Another Happy Day,119.0,"Comedy,Drama","Nov 18, 2011",4000000,9120,978527,-3021473
1643,tt1781058,Wilson,94.0,"Comedy,Drama","Aug 1, 1944",5200000,2000000,2000000,-3200000
1645,tt2796678,The Opposite Sex,97.0,Comedy,"Jan 20, 2015",3300000,0,50206,-3249794
1665,tt9390090,Head Over Heels,,Comedy,"Feb 2, 2001",14000000,10397365,10397365,-3602635
1668,tt6107548,Late Night,102.0,"Comedy,Drama","Jun 7, 2019",4000000,246305,246305,-3753695
1672,tt2751576,Out of the Blue,108.0,"Comedy,Drama","Oct 19, 2007",4600000,728,731767,-3868233
1692,tt1798243,Rudderless,105.0,"Comedy,Drama,Music","Oct 17, 2014",5000000,56001,567219,-4432781
1693,tt6571636,Wonderland,92.0,"Comedy,Drama","Oct 3, 2003",5500000,1060512,1060512,-4439488
1697,tt0790628,The Incredible Burt Wonderstone,100.0,"Adventure,Comedy,Fantasy","Mar 15, 2013",32000000,22537881,27392609,-4607391
1700,tt4701724,Early Man,89.0,"Adventure,Animation,Comedy","Feb 16, 2018",50000000,8267544,45285890,-4714110
1703,tt10300710,Hit & Run,114.0,"Action,Comedy","Aug 22, 2012",22000000,13749300,17216955,-4783045
1707,tt1525366,Grabbers,94.0,"Comedy,Horror,Sci-Fi","Jul 19, 2013",5300000,0,440821,-4859179
1709,tt3776292,Stuck,85.0,"Comedy,Drama","May 30, 2008",5000000,67505,67505,-4932495
1713,tt3838992,Yoga Hosers,88.0,"Action,Comedy,Fantasy","Sep 2, 2016",5000000,0,22958,-4977042
1714,tt6163142,Grace,90.0,"Comedy,Crime,Romance","Aug 14, 2009",5000000,8297,8297,-4991703
1722,tt2402105,Dom Hemingway,93.0,"Comedy,Crime,Drama","Apr 2, 2014",7000000,523511,1857458,-5142542
1725,tt1791528,Inherent Vice,148.0,"Comedy,Crime,Drama","Dec 12, 2014",20000000,8110975,14772346,-5227654
1728,tt1588334,"Jeff, Who Lives at Home",83.0,"Comedy,Drama","Mar 16, 2012",10000000,4269426,4708127,-5291873
1739,tt1251743,Salvation Boulevard,96.0,"Action,Comedy,Drama","Jul 15, 2011",5500000,28468,28468,-5471532
1740,tt2914838,R100,99.0,"Comedy,Drama","Jan 23, 2015",5500000,24956,24956,-5475044
1747,tt1756851,Twixt,88.0,"Comedy,Fantasy,Horror","Jul 23, 2013",7000000,0,1268346,-5731654
1749,tt1598828,One for the Money,91.0,"Action,Comedy,Crime","Jan 27, 2012",42000000,26414527,36197221,-5802779
1758,tt4158096,Free Fire,91.0,"Action,Comedy,Crime","Apr 21, 2017",10000000,1799322,3793739,-6206261
1760,tt3381008,The Brothers Grimsby,83.0,"Action,Adventure,Comedy","Mar 11, 2016",35000000,6864016,28720470,-6279530
1765,tt1152830,The Joneses,117.0,"Comedy,Drama","Apr 16, 2010",10000000,1475746,3541565,-6458435
1767,tt1361313,The Extra Man,108.0,Comedy,"Jul 30, 2010",7000000,453377,492108,-6507892
1768,tt1478964,Attack the Block,88.0,"Action,Comedy,Sci-Fi","Jul 29, 2011",13000000,1024175,6459183,-6540817
1769,tt4622512,Battle of the Sexes,121.0,"Biography,Comedy,Drama","Sep 22, 2017",25000000,12638526,18445379,-6554621
1772,tt1403177,Hesher,106.0,"Comedy,Crime,Drama","May 13, 2011",7000000,382946,382946,-6617054
1773,tt5280954,The Importance of Being Earnest,,Comedy,"May 22, 2002",15000000,8378141,8378141,-6621859
1781,tt2097333,A.C.O.R.N.S.: Operation Crackdown,83.0,"Animation,Comedy,Family","Nov 1, 2016",8500000,0,1353287,-7146713
1785,tt1411664,Bucky Larson: Born to Be a Star,97.0,Comedy,"Sep 9, 2011",10000000,2529395,2529395,-7470605
1786,tt1772422,Outside Bet,101.0,Comedy,"Feb 24, 2015",7500000,0,13524,-7486476
1805,tt1319716,It's a Wonderful Afterlife,100.0,"Comedy,Drama,Fantasy","Oct 8, 2010",10000000,0,1642939,-8357061
1806,tt10265116,Dream House,,"Comedy,Drama,Romance","Sep 30, 2011",50000000,21302340,41642166,-8357834
1807,tt3910736,Gun Shy,92.0,"Action,Adventure,Comedy","Feb 4, 2000",10000000,1638202,1638202,-8361798
1818,tt1336608,Rock of Ages,123.0,"Comedy,Drama,Musical","Jun 15, 2012",70000000,38518613,61031932,-8968068
1823,tt7520136,The Conspirator,,Comedy,"Apr 15, 2011",25000000,11538204,15907411,-9092589
1828,tt2556874,Plastic,102.0,"Action,Comedy,Crime","Sep 26, 2014",10000000,0,575371,-9424629
1829,tt1376195,Gunless,89.0,"Action,Comedy,Drama","Apr 30, 2010",9900000,458054,458054,-9441946
1830,tt6404166,Original Sin,75.0,Comedy,"Aug 3, 2001",26000000,16521410,16521410,-9478590
1835,tt3553442,Whiskey Tango Foxtrot,112.0,"Biography,Comedy,Drama","Mar 4, 2016",35000000,23083334,25350747,-9649253
1838,tt1247667,High School,99.0,Comedy,"Jun 1, 2012",10000000,139034,248133,-9751867
1839,tt3202120,Barbecue,98.0,Comedy,"Dec 26, 2014",10000000,388,247565,-9752435
1840,tt7201846,Edmond,110.0,"Comedy,Drama,History","Jul 14, 2006",10000000,131719,241719,-9758281
1842,tt2113659,Elsa & Fred,93.0,"Comedy,Drama,Romance","Nov 7, 2014",10000000,67657,197901,-9802099
1846,tt4024312,Cursed,81.0,Comedy,"Feb 25, 2005",35000000,19294901,25114901,-9885099
1853,tt1194417,Casino Jack,108.0,"Biography,Comedy,Crime","Dec 17, 2010",12500000,2039869,2272186,-10227814
1862,tt3960412,Popstar: Never Stop Never Stopping,87.0,"Comedy,Music","Jun 3, 2016",20000000,9496130,9537120,-10462880
1866,tt1730687,Darling Companion,103.0,"Comedy,Drama,Romance","Apr 20, 2012",12000000,793352,1200346,-10799654
1873,tt1374989,Pride and Prejudice and Zombies,108.0,"Action,Comedy,Horror","Feb 5, 2016",28000000,10907291,16638300,-11361700
1875,tt1440161,A Little Bit of Heaven,106.0,"Comedy,Drama,Fantasy","May 4, 2012",12500000,10011,1100287,-11399713
1876,tt0810922,Take Me Home Tonight,97.0,"Comedy,Drama,Romance","Mar 4, 2011",19000000,6928068,7576604,-11423396
1880,tt1243974,Aloha,105.0,"Comedy,Drama,Romance","May 29, 2015",37000000,21052030,25387091,-11612909
1881,tt3164256,Rock the Kasbah,106.0,"Comedy,Music,War","Oct 23, 2015",15000000,3020665,3386153,-11613847
1885,tt5531336,Proof,,"Comedy,Mystery,Sci-Fi","Sep 16, 2005",20000000,7535331,8284331,-11715669
1886,tt6471464,Fateless,,Comedy,"Jan 6, 2006",12000000,196857,196857,-11803143
1894,tt7059806,Almost Famous,95.0,"Comedy,Drama,Family","Sep 15, 2000",60000000,32522352,47371191,-12628809
1901,tt1584131,The Last Godfather,100.0,"Comedy,Crime,Romance","Apr 1, 2011",13400000,164247,164247,-13235753
1917,tt6495770,Action Point,85.0,Comedy,"Jun 1, 2018",19000000,5059608,5103675,-13896325
1919,tt1013860,Dylan Dog: Dead of Night,107.0,"Action,Comedy,Crime","Apr 29, 2011",20000000,1186538,6093725,-13906275
1934,tt5721088,Just Getting Started,91.0,"Action,Comedy","Dec 8, 2017",22000000,6069605,6756412,-15243588
1940,tt1719676,Vamps,89.0,"Comedy,Horror,Thriller","Nov 2, 2012",16000000,3361,94812,-15905188
1964,tt0763831,A Thousand Words,91.0,"Comedy,Drama","Mar 9, 2012",40000000,18450127,20790486,-19209514
1965,tt1664697,Middle Men,82.0,"Action,Comedy,Crime","Aug 6, 2010",20000000,754301,754301,-19245699
1969,tt1274300,The Tempest,110.0,"Comedy,Drama,Fantasy","Dec 10, 2010",20000000,277943,277943,-19722057
1974,tt1946502,UglyDolls,87.0,"Adventure,Animation,Comedy","May 3, 2019",45000000,19894664,24644664,-20355336
1978,tt1423894,Barney's Version,134.0,"Comedy,Drama","Jan 14, 2011",30000000,7502560,8845575,-21154425
1991,tt2980210,A Hologram for the King,98.0,"Comedy,Drama,Romance","Apr 22, 2016",35000000,4212494,11846010,-23153990
1994,tt0376136,The Rum Diary,119.0,"Comedy,Drama","Oct 28, 2011",45000000,13109815,21544732,-23455268
2000,tt1240982,Your Highness,102.0,"Adventure,Comedy,Fantasy","Apr 8, 2011",50000000,21596445,26121638,-23878362
2003,tt9201248,What Just Happened,96.0,Comedy,"Oct 17, 2008",27000000,1090947,2412123,-24587877
2004,tt1125929,Love Ranch,117.0,"Biography,Comedy,Drama","Jun 30, 2010",25000000,137885,146149,-24853851
2005,tt4971344,The Sisters Brothers,122.0,"Adventure,Comedy,Crime","Sep 21, 2018",38000000,3143056,13143056,-24856944
2007,tt2425486,Gloria,110.0,"Comedy,Drama,Romance","Jan 22, 1999",30000000,4167493,4967493,-25032507
2008,tt7097350,Kiss of Death,124.0,"Comedy,Drama","Apr 21, 1995",40000000,14942422,14942422,-25057578
2010,tt1137470,Accidental Love,100.0,"Comedy,Romance","Mar 17, 2015",26000000,0,135436,-25864564
2020,tt3045616,Mortdecai,107.0,"Action,Comedy,Crime","Jan 23, 2015",60000000,7696134,30396134,-29603866
2026,tt2788710,The Interview,112.0,Comedy,"Feb 6, 2014",44000000,6105175,12342632,-31657368
2028,tt3289724,Welcome to Marwen,116.0,"Biography,Comedy,Drama","Dec 21, 2018",45000000,10763520,12874922,-32125078
2030,tt1981107,The Young and Prodigious T.S. Spivet,105.0,"Action,Adventure,Comedy","Jul 31, 2015",33000000,176847,357687,-32642313
2031,tt1817771,Freaks of Nature,92.0,"Comedy,Horror,Sci-Fi","Oct 30, 2015",33000000,70958,70958,-32929042
2032,tt1540128,Playing for Keeps,105.0,"Comedy,Romance,Sport","Oct 3, 1986",35000000,2000000,2000000,-33000000
2033,tt1053810,The Big Year,100.0,Comedy,"Oct 14, 2011",41000000,7204138,7684524,-33315476
2036,tt3485166,Pirates,130.0,"Action,Adventure,Comedy","Jul 1, 1986",40000000,1641825,6341825,-33658175
2043,tt2822672,Rock Dog,90.0,"Adventure,Animation,Comedy","Feb 24, 2017",60000000,9420546,24148488,-35851512
2055,tt0249516,Foodfight!,91.0,"Action,Animation,Comedy","Dec 31, 2012",45000000,0,73706,-44926294
2058,tt4722990,Last Man Standing,,Comedy,"Sep 20, 1996",67000000,18115927,18115927,-48884073
2059,tt1727261,Father's Day,99.0,"Action,Comedy,Horror","May 9, 1997",85000000,28681080,35681080,-49318920
2061,tt0790736,R.I.P.D.,96.0,"Action,Adventure,Comedy","Jul 19, 2013",130000000,33618855,79076678,-50923322
2064,tt2352432,Stealth,51.0,"Action,Comedy","Jul 29, 2005",138000000,32116746,76416746,-61583254
2065,tt3095734,Monster Trucks,104.0,"Action,Adventure,Comedy","Jan 13, 2017",125000000,33370166,61642798,-63357202
2068,tt2283336,Men in Black: International,115.0,"Action,Adventure,Comedy","Jun 14, 2019",110000000,3100000,3100000,-106900000
