,tconst,primary_title,runtime_minutes,genres,release_date,production_budget,domestic_gross,worldwide_gross,total_profit
8,tt1323045,Frozen,93.0,"Adventure,Drama,Sport","Nov 22, 2013",150000000,400738009,1272469910,1122469910
20,tt6105098,The Lion King,,"Adventure,Animation,Drama","Jun 15, 1994",79300000,421785283,986214868,906914868
28,tt1727824,Bohemian Rhapsody,134.0,"Biography,Drama,Music","Nov 2, 2018",55000000,216303339,894985342,839985342
33,tt3040964,The Jungle Book,106.0,"Adventure,Drama,Family","Apr 15, 2016",175000000,364001123,962854547,787854547
42,tt2064820,Inside Out,,Drama,"Jun 19, 2015",175000000,356461711,854235992,679235992
49,tt1325004,The Twilight Saga: Eclipse,124.0,"Adventure,Drama,Fantasy","Jun 30, 2010",68000000,300531751,706102828,638102828
58,tt1454468,Gravity,91.0,"Drama,Sci-Fi,Thriller","Oct 4, 2013",110000000,274092705,693698673,583698673
65,tt3659388,The Martian,144.0,"Adventure,Drama,Sci-Fi","Oct 2, 2015",108000000,228433663,655271443,547271443
68,tt2103281,Dawn of the Planet of the Apes,130.0,"Action,Adventure,Drama","Jul 11, 2014",170000000,208545589,710644566,540644566
70,tt2322441,Fifty Shades of Grey,125.0,"Drama,Romance,Thriller","Feb 13, 2015",40000000,166167230,570998101,530998101
77,tt0816692,Interstellar,169.0,"Adventure,Drama,Sci-Fi","Nov 5, 2014",165000000,188017894,666379375,501379375
78,tt0454876,Life of Pi,127.0,"Adventure,Drama,Fantasy","Nov 21, 2012",120000000,124987022,620912003,500912003
82,tt2179136,American Sniper,133.0,"Action,Biography,Drama","Dec 25, 2014",58000000,350126372,547326372,489326372
84,tt1483010,Logan,94.0,"Comedy,Drama,Family","Mar 3, 2017",127000000,226277068,615461394,488461394
104,tt3783958,La La Land,128.0,"Comedy,Drama,Music","Dec 9, 2016",20000000,151101803,426351163,406351163
105,tt3375556,Iron Man,84.0,"Comedy,Drama,Family","May 2, 2008",186000000,318604126,585171547,399171547
113,tt8332280,The Bodyguard,99.0,Drama,"Nov 25, 1992",25000000,121945720,410899039,385899039
116,tt1318514,Rise of the Planet of the Apes,105.0,"Action,Drama,Sci-Fi","Aug 5, 2011",93000000,176760185,470986200,377986200
119,tt8358722,Brave,,Drama,"Jun 22, 2012",185000000,237282182,554606532,369606532
131,tt1853728,Django Unchained,165.0,"Drama,Western","Dec 25, 2012",100000000,162805434,449948323,349948323
132,tt5013056,Dunkirk,106.0,"Action,Drama,History","Jul 21, 2017",150000000,190068280,499837368,349837368
133,tt2126355,San Andreas,114.0,"Action,Adventure,Drama","May 29, 2015",110000000,155190832,456258539,346258539
135,tt6473952,Cast Away,90.0,"Adventure,Drama","Dec 22, 2000",85000000,233632142,427230516,342230516
137,tt3450958,War for the Planet of the Apes,140.0,"Action,Adventure,Drama","Jul 14, 2017",152000000,146880162,489592267,337592267
144,tt4465564,Fifty Shades Darker,118.0,"Drama,Romance","Feb 10, 2017",55000000,114434010,381398492,326398492
145,tt4418168,Ice Age,106.0,"Crime,Drama,Family","Mar 15, 2002",65000000,176387405,386116343,321116343
146,tt0947798,Black Swan,108.0,"Drama,Thriller","Dec 3, 2010",13000000,106954678,331266710,318266710
148,tt4477536,Fifty Shades Freed,105.0,"Drama,Romance,Thriller","Feb 9, 2018",55000000,100407760,371350619,316350619
150,tt2477178,Hitch,70.0,Drama,"Feb 11, 2005",55000000,177784257,366784257,311784257
151,tt1155076,The Karate Kid,140.0,"Action,Drama,Family","Jun 11, 2010",40000000,176591618,351774938,311774938
155,tt2267998,Gone Girl,149.0,"Drama,Mystery,Thriller","Oct 3, 2014",61000000,167767189,368567189,307567189
157,tt1705952,Tarzan,94.0,"Adventure,Animation,Drama","Jun 16, 1999",145000000,171091819,448191819,303191819
158,tt1485796,The Greatest Showman,105.0,"Biography,Drama,Musical","Dec 20, 2017",84000000,174340174,386665550,302665550
161,tt6966692,Green Book,130.0,"Biography,Comedy,Drama","Nov 16, 2018",23000000,85080171,322034439,299034439
166,tt2582846,The Fault in Our Stars,126.0,"Drama,Romance","Jun 6, 2014",12000000,124872350,307166834,295166834
168,tt3402236,Murder on the Orient Express,114.0,"Crime,Drama,Mystery","Nov 10, 2017",55000000,102826543,345922730,290922730
171,tt0993846,The Wolf of Wall Street,180.0,"Biography,Crime,Drama","Dec 25, 2013",100000000,116900694,389870414,289870414
173,tt2543472,Wonder,113.0,"Drama,Family","Nov 17, 2017",20000000,132422809,304604712,284604712
180,tt9574324,Chicago,,"Comedy,Crime,Drama","Dec 27, 2002",30000000,170687518,306770545,276770545
183,tt3315656,Split,127.0,"Drama,Fantasy","Jan 20, 2017",5000000,138141585,278964806,273964806
186,tt1831825,Wanted,160.0,"Action,Drama","Jun 27, 2008",75000000,134508551,342416460,267416460
196,tt4036590,Speed,108.0,Drama,"Jun 10, 1994",30000000,121248145,283200000,253200000
197,tt9702034,Neighbors,,Drama,"May 9, 2014",18000000,150086800,270944428,252944428
202,tt1502712,Fantastic Four,100.0,"Action,Adventure,Drama","Jul 8, 2005",87500000,154696080,333132750,245632750
206,tt8870574,Ransom,98.0,"Drama,Thriller","Nov 8, 1996",70000000,136492681,308700000,238700000
213,tt2708782,Us,92.0,Drama,"Mar 22, 2019",20000000,175006930,254210310,234210310
214,tt4849438,Baahubali 2: The Conclusion,167.0,"Action,Drama","Apr 28, 2017",30000000,18985794,263502914,233502914
216,tt1735898,Snow White and the Huntsman,127.0,"Action,Adventure,Drama","Jun 1, 2012",170000000,155136755,401021746,231021746
223,tt9430578,Rocky,,"Action,Drama,Romance","Nov 21, 1976",1000000,117235147,225000000,224000000
224,tt1959490,Noah,138.0,"Action,Adventure,Drama","Mar 28, 2014",130000000,101200044,352831065,222831065
231,tt1800241,American Hustle,138.0,"Crime,Drama","Dec 13, 2013",40000000,150117807,257878294,217878294
232,tt1403865,True Grit,110.0,"Adventure,Drama,Western","Dec 22, 2010",35000000,171243005,252276928,217276928
233,tt1045658,Silver Linings Playbook,122.0,"Comedy,Drama,Romance","Nov 16, 2012",21000000,132092958,236412453,215412453
234,tt4566758,Mulan,,"Adventure,Drama,Family","Jun 19, 1998",90000000,120620254,303500000,213500000
235,tt2084970,The Imitation Game,114.0,"Biography,Drama,Thriller","Nov 28, 2014",15000000,91125143,227740463,212740463
242,tt0443272,Lincoln,150.0,"Biography,Drama,History","Nov 9, 2012",65000000,182207973,273346281,208346281
245,tt4846340,Hidden Figures,127.0,"Biography,Drama,History","Dec 25, 2016",25000000,169607287,231771716,206771716
249,tt1261945,Sex and the City 2,146.0,"Comedy,Drama,Romance","May 27, 2010",95000000,95347692,294680778,199680778
250,tt9111170,What Lies Beneath,,"Drama,Mystery,Thriller","Jul 21, 2000",90000000,155464351,288693989,198693989
251,tt6673682,Big Daddy,138.0,Drama,"Jun 25, 1999",30000000,163479795,228641283,198641283
257,tt3890160,Baby Driver,113.0,"Action,Crime,Drama","Jun 28, 2017",34000000,107825862,228104185,194104185
259,tt1355644,Passengers,116.0,"Drama,Romance,Sci-Fi","Dec 21, 2016",110000000,100014699,302239672,192239672
262,tt2674426,Me Before You,106.0,"Drama,Romance","Jun 3, 2016",20000000,56245075,208265198,188265198
263,tt1454029,The Help,146.0,Drama,"Aug 10, 2011",25000000,169705587,213120004,188120004
267,tt1285016,The Social Network,120.0,"Biography,Drama","Oct 1, 2010",40000000,96962694,224922135,184922135
270,tt9691476,Snow White and the Seven Dwarfs,,"Comedy,Drama,Fantasy","Dec 21, 1937",1488000,184925486,184925486,183437486
271,tt1024648,Argo,120.0,"Biography,Drama,Thriller","Oct 12, 2012",44500000,136025503,227140757,182640757
276,tt3263904,Sully,96.0,"Biography,Drama","Sep 9, 2016",60000000,125070033,238524556,178524556
278,tt5580390,The Shape of Water,123.0,"Adventure,Drama,Fantasy","Dec 1, 2017",19500000,63859435,195790794,176290794
283,tt1398426,Straight Outta Compton,147.0,"Biography,Drama,History","Aug 14, 2015",28000000,161197785,202182981,174182981
287,tt0918940,The Legend of Tarzan,110.0,"Action,Adventure,Drama","Jul 1, 2016",180000000,126643061,348902025,168902025
288,tt1606389,The Vow,104.0,"Drama,Romance","Feb 10, 2012",30000000,125014030,197618160,167618160
293,tt1783264,Elysium,,Drama,"Aug 9, 2013",120000000,93050117,286192091,166192091
294,tt1535109,Captain Phillips,134.0,"Biography,Drama,Thriller","Oct 11, 2013",55000000,107136417,220648184,165648184
297,tt6343314,Creed II,130.0,"Drama,Sport","Nov 21, 2018",50000000,115715889,213591522,163591522
298,tt1915581,Magic Mike,110.0,"Comedy,Drama","Jun 29, 2012",7000000,113721571,170549753,163549753
302,tt1343092,The Great Gatsby,143.0,"Drama,Romance","May 10, 2013",190000000,144840419,351040419,161040419
303,tt2024544,12 Years a Slave,134.0,"Biography,Drama,History","Oct 18, 2013",20000000,56671993,181025343,161025343
311,tt2361509,The Intern,121.0,"Comedy,Drama","Sep 25, 2015",40000000,75764672,197115710,157115710
315,tt5838908,The Descendants,80.0,Drama,"Nov 16, 2011",20000000,82624961,175507800,155507800
318,tt1596723,Click,127.0,"Drama,Horror,Mystery","Jun 23, 2006",82500000,137355633,237685089,155185089
320,tt6162924,Live and Let Die,45.0,"Drama,War","Jun 27, 1973",7000000,35400000,161800000,154800000
322,tt0433035,Real Steel,127.0,"Action,Drama,Family","Oct 7, 2011",110000000,85463309,263880341,153880341
327,tt0829150,Dracula Untold,92.0,"Action,Drama,Fantasy","Oct 10, 2014",70000000,55991880,220241723,150241723
328,tt1568346,The Girl with the Dragon Tattoo,158.0,"Crime,Drama,Mystery","Dec 20, 2011",90000000,102515793,239373970,149373970
330,tt5521836,Panic Room,,"Action,Drama,Mystery","Mar 29, 2002",48000000,95308367,196308367,148308367
331,tt5027774,"Three Billboards Outside Ebbing, Missouri",115.0,"Crime,Drama","Nov 10, 2017",12000000,54513740,160191915,148191915
332,tt1327773,Lee Daniels' The Butler,132.0,"Biography,Drama","Aug 16, 2013",30000000,116632095,177025498,147025498
334,tt0879870,Eat Pray Love,133.0,"Drama,Romance","Aug 13, 2010",60000000,80574010,206598789,146598789
337,tt2347134,Unforgiven,135.0,"Action,Crime,Drama","Aug 7, 1992",14400000,101157447,159157447,144757447
339,tt1646127,Lights Out,87.0,"Drama,Mystery,Thriller","Jul 22, 2016",5000000,67268835,148806510,143806510
340,tt6840314,City of Angels,,"Action,Drama,Horror","Apr 10, 1998",55000000,78750909,198750909,143750909
344,tt1276104,Looper,113.0,"Action,Crime,Drama","Sep 28, 2012",30000000,66486205,170466405,140466405
346,tt2923554,Jumper,5.0,"Biography,Documentary,Drama","Feb 14, 2008",82500000,80172128,222640812,140140812
351,tt2989872,Lion,70.0,"Comedy,Drama,Romance","Nov 25, 2016",12000000,51739495,149570720,137570720
352,tt3076658,Creed,133.0,"Drama,Sport","Nov 25, 2015",37000000,109767581,173567581,136567581
353,tt1253864,Immortals,110.0,"Action,Drama,Fantasy","Nov 11, 2011",75000000,83504017,211562435,136562435
356,tt1193631,Step Up 3D,107.0,"Drama,Music,Romance","Aug 6, 2010",30000000,42400223,165889117,135889117
360,tt5437970,Mama,90.0,Drama,"Jan 18, 2013",15000000,71628180,148095566,133095566
362,tt1800741,Step Up Revolution,99.0,"Drama,Music,Romance","Jul 27, 2012",33000000,35074677,165552290,132552290
363,tt10340148,Midnight in Paris,75.0,"Comedy,Documentary,Drama","May 20, 2011",30000000,56816662,162502774,132502774
364,tt2713180,Fury,134.0,"Action,Drama,War","Oct 17, 2014",80000000,85817906,210315681,130315681
365,tt1637688,In Time,109.0,"Action,Crime,Drama","Oct 28, 2011",35000000,37553932,165103952,130103952
367,tt6294822,The Post,116.0,"Biography,Drama,History","Dec 22, 2017",50000000,81903458,179748880,129748880
368,tt1649419,The Impossible,114.0,"Drama,History,Thriller","Dec 21, 2012",40000000,19019882,169590606,129590606
369,tt1907668,Flight,138.0,"Drama,Thriller","Nov 2, 2012",31000000,93772375,160558438,129558438
372,tt2119532,Hacksaw Ridge,139.0,"Biography,Drama,History","Nov 4, 2016",40000000,67209615,168904682,128904682
375,tt1528100,Exodus: Gods and Kings,150.0,"Action,Adventure,Drama","Dec 12, 2014",140000000,65014513,268314513,128314513
378,tt4400038,Chocolat,119.0,"Biography,Drama","Dec 15, 2000",25000000,71309760,152500343,127500343
384,tt1412386,The Best Exotic Marigold Hotel,124.0,"Comedy,Drama,Romance","May 4, 2012",10000000,46383639,134639780,124639780
390,tt3682448,Bridge of Spies,142.0,"Drama,History,Thriller","Oct 16, 2015",40000000,72313754,162498338,122498338
393,tt1815862,After Earth,100.0,"Action,Adventure,Drama","May 31, 2013",130000000,60522097,251499665,121499665
394,tt0804509,The Mule,100.0,"Comedy,Drama","Dec 14, 2018",50000000,103804407,170857676,120857676
395,tt4555426,Darkest Hour,125.0,"Biography,Drama,History","Nov 22, 2017",30000000,56443120,150807172,120807172
397,tt1677036,The Holiday,97.0,Drama,"Dec 8, 2006",85000000,63280000,205190324,120190324
398,tt6209808,Phenomenon,,Drama,"Jul 5, 1996",32000000,104636382,152036382,120036382
403,tt0964517,The Fighter,116.0,"Biography,Drama,Sport","Dec 10, 2010",11000000,93617009,129262388,118262388
405,tt0989757,Dear John,108.0,"Drama,Romance,War","Feb 5, 2010",25000000,80014842,142033509,117033509
409,tt0840361,The Town,125.0,"Crime,Drama,Thriller","Sep 17, 2010",37000000,92186262,152566881,115566881
413,tt1596365,The Woman in Black,95.0,"Drama,Fantasy,Horror","Feb 3, 2012",15000000,54333290,128955898,113955898
414,tt2548096,The Queen,104.0,"Action,Drama,War","Sep 30, 2006",15000000,56441711,128885873,113885873
417,tt2140479,The Accountant,128.0,"Action,Crime,Drama","Oct 14, 2016",40000000,86260045,152962083,112962083
418,tt3564472,Girls Trip,122.0,"Comedy,Drama","Jul 21, 2017",28000000,115108515,140886353,112886353
421,tt6498340,End of Days,72.0,"Comedy,Documentary,Drama","Nov 24, 1999",100000000,66889043,212026975,112026975
423,tt1706593,Chronicle,84.0,"Drama,Sci-Fi,Thriller","Feb 3, 2012",12000000,64575175,123681790,111681790
430,tt1091191,Lone Survivor,121.0,"Action,Biography,Drama","Dec 25, 2013",40000000,125095601,149804632,109804632
432,tt2268016,Magic Mike XXL,115.0,"Comedy,Drama,Music","Jul 1, 2015",14500000,66013057,123660597,109160597
433,tt3863552,Bajrangi Bhaijaan,163.0,"Action,Comedy,Drama","Jul 17, 2015",13000000,8178001,121778347,108778347
435,tt0945513,Source Code,93.0,"Action,Drama,Sci-Fi","Apr 1, 2011",32000000,54712227,140428499,108428499
436,tt2980516,The Theory of Everything,123.0,"Biography,Drama,Romance","Nov 7, 2014",15000000,35893537,123327692,108327692
438,tt3152624,Trainwreck,125.0,"Comedy,Drama,Romance","Jul 17, 2015",35000000,110212700,141123897,106123897
440,tt4052882,The Shallows,86.0,"Drama,Horror,Thriller","Jun 24, 2016",13000000,55121623,118763442,105763442
442,tt1596363,The Big Short,130.0,"Biography,Comedy,Drama","Dec 11, 2015",28000000,70259870,133162752,105162752
443,tt4085696,Billy Elliot,169.0,"Comedy,Drama,Music","Oct 13, 2000",5000000,21995263,109253745,104253745
445,tt1179933,10 Cloverfield Lane,103.0,"Drama,Horror,Mystery","Mar 11, 2016",5000000,72082999,108286422,103286422
446,tt1535438,Hope Springs,100.0,"Comedy,Drama,Romance","Aug 8, 2012",30000000,63536011,133085295,103085295
447,tt2381941,Focus,105.0,"Comedy,Crime,Drama","Feb 27, 2015",65000000,53862963,168065700,103065700
452,tt1007029,The Iron Lady,105.0,"Biography,Drama","Jan 13, 2012",14000000,29959436,115592104,101592104
459,tt4653310,Driving Miss Daisy,100.0,"Comedy,Drama","Dec 13, 1989",7500000,106593296,106593296,99093296
461,tt2516968,Step Up,55.0,"Biography,Documentary,Drama","Aug 11, 2006",12000000,65328121,110989157,98989157
463,tt1809398,Unbroken,137.0,"Biography,Drama,Sport","Dec 25, 2014",65000000,115637895,163527824,98527824
467,tt0359950,The Secret Life of Walter Mitty,114.0,"Adventure,Comedy,Drama","Dec 25, 2013",91000000,58236838,187861183,96861183
470,tt1605776,The Visit,90.0,"Comedy,Drama,Romance","Sep 11, 2015",5000000,65206105,98677816,93677816
482,tt3582040,Boomerang,101.0,"Drama,Romance","Jul 1, 1992",42000000,70052444,131052444,89052444
484,tt2177771,The Monuments Men,118.0,"Comedy,Drama,History","Feb 7, 2014",70000000,78031620,158702748,88702748
485,tt1667353,Mirror Mirror,106.0,"Adventure,Comedy,Drama","Mar 30, 2012",85000000,64935167,173613482,88613482
487,tt6864720,The Net,75.0,Drama,"Jul 28, 1995",22000000,50621733,110521733,88521733
492,tt2431286,Philomena,98.0,"Biography,Comedy,Drama","Nov 22, 2013",12000000,37709979,98963392,86963392
493,tt3313072,War Horse,,Drama,"Dec 25, 2011",70000000,79883359,156815529,86815529
497,tt2324384,The Notebook,112.0,"Drama,War","Jun 25, 2004",30000000,81001787,116025023,86025023
499,tt3460252,The Hateful Eight,168.0,"Crime,Drama,Mystery","Dec 25, 2015",62000000,54117416,147864886,85864886
501,tt2562232,Birdman or (The Unexpected Virtue of Ignorance),119.0,"Comedy,Drama","Oct 17, 2014",18000000,42340598,103215094,85215094
504,tt1204975,Last Vegas,105.0,"Comedy,Drama","Jan 28, 2013",28000000,63914167,112914167,84914167
505,tt2334873,Blue Jasmine,98.0,Drama,"Jul 26, 2013",18000000,33404871,102912961,84912961
509,tt4897908,Calendar Girls,131.0,Drama,"Dec 19, 2003",10000000,31011616,93074616,83074616
511,tt1179056,A Nightmare on Elm Street,95.0,"Crime,Drama,Horror","Apr 30, 2010",35000000,63075011,117729621,82729621
512,tt6112220,The Butterfly Effect,85.0,"Comedy,Crime,Drama","Jan 23, 2004",13000000,57924679,95638592,82638592
513,tt1790885,Zero Dark Thirty,157.0,"Drama,Thriller","Dec 19, 2012",52500000,95720716,134612435,82112435
515,tt1987680,The Upside,126.0,"Comedy,Drama","Jan 11, 2019",37500000,108235497,119024536,81524536
516,tt3667264,Closer,87.0,Drama,"Dec 3, 2004",35000000,33987757,116177695,81177695
518,tt6857166,Book Club,104.0,"Comedy,Drama,Romance","May 18, 2018",10000000,68566296,91113683,81113683
519,tt3591950,Fantasia,86.0,Drama,"Nov 13, 1940",2280000,83320000,83320000,81040000
521,tt2555736,The Second Best Exotic Marigold Hotel,122.0,"Comedy,Drama","Mar 6, 2015",10000000,33078266,90384306,80384306
523,tt2140373,Saving Mr. Banks,125.0,"Biography,Comedy,Drama","Dec 13, 2013",35000000,83299761,114962525,79962525
525,tt5846676,The Saint,96.0,Drama,"Apr 4, 1997",90000000,61363304,169400000,79400000
526,tt5083738,The Favourite,119.0,"Biography,Drama,History","Nov 23, 2018",15000000,34366783,94113929,79113929
527,tt0881320,Sanctum,108.0,"Adventure,Drama,Thriller","Feb 4, 2011",30000000,23209310,108957098,78957098
529,tt1067583,Water for Elephants,120.0,"Drama,Romance","Apr 22, 2011",38000000,58709717,116809717,78809717
530,tt1037705,The Book of Eli,118.0,"Action,Adventure,Drama","Jan 15, 2010",80000000,94835059,158750817,78750817
531,tt6450186,I Can Only Imagine,110.0,"Biography,Drama,Family","Mar 16, 2018",7000000,83482352,85604221,78604221
532,tt2241035,The Color Purple,97.0,"Action,Drama","Dec 18, 1985",15000000,93589701,93589701,78589701
533,tt7349662,BlacKkKlansman,135.0,"Biography,Crime,Drama","Aug 10, 2018",15000000,49275340,93017335,78017335
534,tt7040874,A Simple Favor,117.0,"Comedy,Crime,Drama","Sep 14, 2018",20000000,53548586,97628717,77628717
535,tt1598778,Contagion,106.0,"Action,Drama,Thriller","Sep 9, 2011",60000000,75658097,137551594,77551594
536,tt1825801,Hostel,111.0,"Action,Crime,Drama","Jan 6, 2006",4800000,47326473,82241110,77441110
537,tt2194499,About Time,123.0,"Comedy,Drama,Fantasy","Nov 1, 2013",12000000,15323921,89309178,77309178
538,tt2873282,Red Sparrow,140.0,"Action,Drama,Thriller","Mar 2, 2018",69000000,46874505,145951861,76951861
543,tt6376046,Stripes,85.0,Drama,"Jun 26, 1981",10000000,85300000,85300000,75300000
546,tt1856101,Blade Runner 2049,164.0,"Drama,Mystery,Sci-Fi","Oct 6, 2017",185000000,92054159,259357408,74357408
548,tt2529924,The Strangers,,"Action,Drama,Horror","May 30, 2008",9000000,52597610,83051676,74051676
551,tt6472976,Five Feet Apart,116.0,"Drama,Romance","Mar 15, 2019",7000000,45729221,80504421,73504421
552,tt3622592,Paper Towns,109.0,"Comedy,Drama,Mystery","Jul 24, 2015",12000000,32000304,85450484,73450484
553,tt1524137,Contraband,109.0,"Action,Crime,Drama","Jan 13, 2012",25000000,66528000,98406855,73406855
556,tt2304933,The 5th Wave,112.0,"Action,Adventure,Drama","Jan 22, 2016",38000000,34912982,111336398,73336398
558,tt4361050,Ouija: Origin of Evil,99.0,"Drama,Horror,Mystery","Oct 21, 2016",9000000,35144505,81831866,72831866
559,tt7368554,The Interpreter,113.0,"Comedy,Drama","Apr 22, 2005",90000000,72708161,162753837,72753837
560,tt1294226,The Last Song,107.0,"Drama,Music,Romance","Mar 31, 2010",20000000,62950384,92678948,72678948
561,tt2072962,The Client,123.0,"Drama,Thriller","Jul 20, 1994",45000000,92115211,117615211,72615211
563,tt2980648,The Hundred-Foot Journey,122.0,"Comedy,Drama","Aug 8, 2014",22000000,54235441,94270488,72270488
564,tt7785302,Spotlight,99.0,Drama,"Nov 6, 2015",20000000,45055776,92088460,72088460
565,tt1068242,Footloose,113.0,"Comedy,Drama,Music","Feb 17, 1984",8200000,80000000,80000000,71800000
566,tt7401588,Instant Family,118.0,"Comedy,Drama","Nov 16, 2018",48000000,67363237,119736188,71736188
567,tt1327194,The Lucky One,101.0,"Drama,Romance","Apr 20, 2012",25000000,60457138,96633833,71633833
571,tt1205537,Jack Ryan: Shadow Recruit,105.0,"Action,Drama,Thriller","Jan 17, 2014",60000000,50577412,131377412,71377412
573,tt3832914,War Room,120.0,Drama,"Aug 28, 2015",3000000,67790117,73975239,70975239
577,tt1591479,Act of Valor,110.0,"Action,Adventure,Drama","Feb 24, 2012",12000000,70012847,82497035,70497035
579,tt8107598,Earth,86.0,Drama,"Apr 22, 2009",47000000,32011576,116773317,69773317
583,tt4034228,Manchester by the Sea,137.0,Drama,"Nov 18, 2016",8500000,47695371,77733867,69233867
585,tt1389137,We Bought a Zoo,124.0,"Comedy,Drama,Family","Dec 23, 2011",50000000,75624550,118729073,68729073
586,tt4925292,Lady Bird,94.0,"Comedy,Drama","Nov 3, 2017",10000000,48958273,78610769,68610769
587,tt1320244,The Last Exorcism,87.0,"Drama,Horror,Thriller","Aug 27, 2010",1800000,41034350,70165900,68365900
589,tt1282140,Easy A,92.0,"Comedy,Drama,Romance","Sep 17, 2010",8000000,58401464,76200721,68200721
591,tt1055292,Life as We Know It,114.0,"Comedy,Drama,Romance","Oct 8, 2010",38000000,53374681,105887837,67887837
592,tt3506476,The Golden Child,86.0,Drama,"Dec 12, 1986",12000000,79817937,79817937,67817937
593,tt2066051,Rocketman,121.0,"Biography,Drama,Music","May 31, 2019",41000000,57342725,108642725,67642725
594,tt5889398,Insomnia,,Drama,"May 24, 2002",46000000,67263182,113622499,67622499
595,tt1392214,Prisoners,153.0,"Crime,Drama,Mystery","Sep 20, 2013",46000000,61002302,113402302,67402302
596,tt1355630,If I Stay,107.0,"Drama,Fantasy,Music","Aug 22, 2014",11000000,50474843,78356170,67356170
600,tt2286560,Frankenstein,82.0,"Drama,Horror","Nov 4, 1994",45000000,22006296,112006296,67006296
604,tt0453562,42,128.0,"Biography,Drama,Sport","Apr 12, 2013",31000000,95020213,97470701,66470701
605,tt2241351,Money Monster,98.0,"Crime,Drama,Thriller","May 13, 2016",27000000,41012075,93466095,66466095
606,tt6593054,Drive,147.0,"Action,Crime,Drama","Sep 16, 2011",15000000,35060689,81357930,66357930
607,tt1702439,Safe Haven,115.0,"Drama,Romance,Thriller","Feb 14, 2013",28000000,71399120,94050951,66050951
611,tt3107798,Rambo,144.0,"Comedy,Drama,Thriller","Jan 25, 2008",47500000,42754105,112214531,64714531
614,tt1798684,Southpaw,124.0,"Drama,Sport","Jul 24, 2015",30000000,52421953,94156456,64156456
620,tt4832640,Sultan,170.0,"Action,Drama,Sport","Jul 6, 2016",11000000,5599781,72989781,61989781
622,tt1196141,Diary of a Wimpy Kid,94.0,"Comedy,Drama,Family","Mar 19, 2010",15000000,64003625,76954311,61954311
624,tt1210166,Moneyball,133.0,"Biography,Drama,Sport","Sep 23, 2011",50000000,75605492,111300835,61300835
626,tt2504404,Wolf,122.0,"Crime,Drama,Thriller","Jun 17, 1994",70000000,65011757,131011757,61011757
627,tt1945037,Begin Again,68.0,"Drama,Family","Jun 27, 2014",8000000,16170632,68838736,60838736
628,tt4257926,Miracles from Heaven,109.0,"Biography,Drama,Family","Mar 16, 2016",13000000,61705123,73798736,60798736
629,tt1340800,Tinker Tailor Soldier Spy,122.0,"Drama,Mystery,Thriller","Dec 9, 2011",21000000,24149393,81452811,60452811
631,tt1161864,The Rite,114.0,"Drama,Horror,Mystery","Jan 28, 2011",37000000,33047633,97143987,60143987
632,tt7784604,Hereditary,127.0,"Drama,Horror,Mystery","Jun 8, 2018",10000000,44069456,70133905,60133905
640,tt1564349,Dolphin Tale,113.0,"Drama,Family","Sep 23, 2011",37000000,72286779,96068724,59068724
641,tt4746516,Orphan,111.0,Drama,"Jul 24, 2009",20000000,41596251,78769428,58769428
642,tt1212419,Hereafter,129.0,"Drama,Fantasy,Romance","Oct 15, 2010",50000000,32746941,108660270,58660270
644,tt2177672,Casino,,Drama,"Nov 22, 1995",52000000,42438300,110400000,58400000
647,tt2638144,Ben-Hur,123.0,"Action,Adventure,Drama","Nov 18, 1959",15000000,73000000,73259017,58259017
648,tt2443822,The Boy,105.0,"Drama,Horror,Thriller","Jan 22, 2016",10000000,35819556,68220952,58220952
651,tt0498381,Rings,102.0,"Drama,Horror,Mystery","Feb 3, 2017",25000000,27793018,82917283,57917283
652,tt1219827,Ghost in the Shell,107.0,"Action,Drama,Sci-Fi","Mar 31, 2017",110000000,40563557,167910690,57910690
657,tt0816442,The Book Thief,131.0,"Drama,War","Nov 8, 2013",19000000,21488481,76086711,57086711
660,tt1601913,The Grey,117.0,"Action,Adventure,Drama","Jan 27, 2012",25000000,51580136,81249176,56249176
661,tt1823672,Chappie,120.0,"Action,Crime,Drama","Mar 6, 2015",49000000,31569268,105002056,56002056
663,tt2083355,The Best Man Holiday,123.0,"Comedy,Drama","Nov 15, 2013",17000000,70525195,72835710,55835710
665,tt0790636,Dallas Buyers Club,117.0,"Biography,Drama","Nov 1, 2013",5000000,27298285,60611845,55611845
666,tt5164432,"Love, Simon",110.0,"Comedy,Drama,Romance","Mar 16, 2018",10000000,40826341,65520633,55520633
667,tt2334879,White House Down,131.0,"Action,Drama,Thriller","Jun 28, 2013",150000000,73103784,205440387,55440387
671,tt8155288,Happy Death Day 2U,100.0,"Drama,Horror,Mystery","Feb 13, 2019",9000000,28051045,64179495,55179495
673,tt1124035,The Ides of March,101.0,"Drama,Thriller","Oct 7, 2011",23000000,40962534,77735925,54735925
675,tt3397884,Sicario,121.0,"Action,Crime,Drama","Sep 18, 2015",30000000,46889293,84393749,54393749
676,tt6149830,Identity,75.0,Drama,"Apr 25, 2003",28000000,52131264,82183683,54183683
678,tt2091436,The Gift,54.0,"Drama,Romance","Aug 7, 2015",5000000,43787265,58978477,53978477
679,tt3303730,Obsessed,132.0,Drama,"Apr 24, 2009",20000000,68261644,73964713,53964713
681,tt4361256,Witness,60.0,Drama,"Feb 8, 1985",12000000,65532576,65532576,53532576
683,tt7442358,Devil,89.0,Drama,"Sep 17, 2010",10000000,33679655,63354114,53354114
684,tt1065073,Boyhood,165.0,Drama,"Jul 11, 2014",4000000,25379975,57273049,53273049
685,tt1748122,Moonrise Kingdom,94.0,"Adventure,Comedy,Drama","May 25, 2012",16000000,45512466,68848446,52848446
688,tt4795124,How to Be a Latin Lover,115.0,"Comedy,Drama","Apr 28, 2017",10000000,32149404,62556228,52556228
689,tt1939659,Carrie,100.0,"Drama,Horror","Oct 18, 2013",30000000,35266619,82409520,52409520
690,tt0892318,Letters to Juliet,105.0,"Adventure,Comedy,Drama","May 14, 2010",30000000,53032453,82148538,52148538
694,tt5001718,"Everything, Everything",96.0,"Drama,Romance","May 19, 2017",10000000,34121140,61603136,51603136
697,tt3184798,Brooklyn,83.0,"Drama,Music,Musical","Nov 4, 2015",11000000,38322743,62076141,51076141
698,tt1586265,What to Expect When You're Expecting,110.0,"Comedy,Drama,Romance","May 18, 2012",37500000,41152203,88473016,50973016
702,tt1259528,Den of Thieves,140.0,"Action,Crime,Drama","Jan 19, 2018",30000000,44947622,80131391,50131391
707,tt1616195,J. Edgar,137.0,"Biography,Crime,Drama","Nov 9, 2011",35000000,37306030,84606030,49606030
708,tt8259618,Serendipity,107.0,Drama,"Oct 5, 2001",28000000,50255310,77477297,49477297
709,tt4163946,Snow Day,60.0,"Action,Documentary,Drama","Feb 11, 2000",13000000,60008303,62452927,49452927
711,tt4682786,Collateral Beauty,97.0,"Drama,Romance","Dec 16, 2016",36000000,31016021,85309093,49309093
712,tt1967669,Tag,91.0,Drama,"Jun 15, 2018",28000000,54730625,77026186,49026186
713,tt5462602,The Big Sick,120.0,"Comedy,Drama,Romance","Jun 23, 2017",5000000,42872467,53972860,48972860
714,tt3210686,Son of God,138.0,"Biography,Drama,History","Feb 28, 2014",22000000,59700064,70949793,48949793
715,tt4244998,Alpha,96.0,"Adventure,Drama,Family","Aug 17, 2018",51000000,35851379,99624873,48624873
716,tt2387559,Delivery Man,105.0,"Comedy,Drama","Nov 22, 2013",22000000,30659817,70536870,48536870
718,tt2466604,Sky High,70.0,"Adventure,Documentary,Drama","Jul 29, 2005",35000000,63939454,83109359,48109359
719,tt1706620,Snowpiercer,126.0,"Action,Drama,Sci-Fi","Jun 27, 2014",40000000,4563029,88069880,48069880
720,tt1440728,The American,105.0,"Crime,Drama,Thriller","Sep 1, 2010",20000000,35606376,67950723,47950723
723,tt2126357,Second Act,103.0,"Comedy,Drama,Romance","Dec 21, 2018",15700000,39282227,63288854,47588854
724,tt2404425,Woman in Gold,109.0,"Biography,Drama,History","Apr 1, 2015",11000000,33307793,58586407,47586407
726,tt1189340,The Lincoln Lawyer,118.0,"Crime,Drama,Thriller","Mar 18, 2011",40000000,58009200,87145086,47145086
727,tt4706692,Exit Wounds,11.0,"Documentary,Drama,War","Mar 16, 2001",33000000,51758599,79958599,46958599
729,tt1020072,Selma,128.0,"Biography,Drama,History","Jan 9, 2015",20000000,52076908,66776576,46776576
732,tt7501058,Ordinary People,91.0,Drama,"Sep 19, 1980",6000000,52302978,52302978,46302978
736,tt2193215,The Counselor,117.0,"Crime,Drama,Thriller","Oct 25, 2013",25000000,16973715,71009334,46009334
737,tt1355683,Black Mass,123.0,"Biography,Crime,Drama","Sep 18, 2015",53000000,62575678,98837872,45837872
739,tt7137846,Breaking In,88.0,"Action,Crime,Drama","May 11, 2018",6000000,46840590,51411620,45411620
740,tt1213641,First Man,141.0,"Biography,Drama,History","Oct 12, 2018",60000000,44936545,105203825,45203825
741,tt1441951,Quartet,94.0,"Comedy,Drama","Jan 11, 2013",11000000,18388357,56178935,45178935
742,tt7694546,Beowulf,80.0,"Action,Drama,Fantasy","Nov 16, 2007",150000000,82280579,195080579,45080579
744,tt2357461,Honey,96.0,Drama,"Dec 5, 2003",18000000,30272254,62646763,44646763
745,tt8383596,Stand by Me,91.0,Drama,"Aug 8, 1986",8000000,52287414,52287414,44287414
746,tt1563738,One Day,107.0,"Drama,Romance","Aug 19, 2011",15000000,13843771,59168692,44168692
748,tt1321870,Gangster Squad,113.0,"Action,Crime,Drama","Jan 11, 2013",60000000,46000903,104100903,44100903
749,tt1737256,The Island,95.0,"Drama,Romance","Jul 22, 2005",120000000,35818913,163018913,43018913
750,tt2948840,Life,111.0,"Biography,Drama","Mar 24, 2017",58000000,30234022,100929666,42929666
751,tt0882977,Snitch,112.0,"Action,Drama,Thriller","Feb 22, 2013",15000000,42930462,57907734,42907734
753,tt5580036,"I, Tonya",120.0,"Biography,Comedy,Drama","Dec 8, 2017",11000000,30014534,53797409,42797409
755,tt1855199,End of Watch,109.0,"Action,Crime,Drama","Sep 21, 2012",15000000,41003371,57586606,42586606
756,tt2178470,Yeh Jawaani Hai Deewani,160.0,"Comedy,Drama,Musical","May 31, 2013",8300000,3827466,50827466,42527466
757,tt3862750,The Perfect Guy,100.0,"Crime,Drama,Horror","Sep 11, 2015",18000000,57027435,60278166,42278166
759,tt1542344,127 Hours,94.0,"Adventure,Biography,Drama","Nov 5, 2010",18000000,18335230,60217171,42217171
760,tt0475290,"Hail, Caesar!",106.0,"Comedy,Drama,Music","Feb 5, 2016",22000000,30080225,64160680,42160680
762,tt2170593,St. Vincent,102.0,"Comedy,Drama","Oct 10, 2014",13000000,44137712,54837234,41837234
763,tt2872718,Nightcrawler,117.0,"Crime,Drama,Thriller","Oct 31, 2014",8500000,32381218,50334418,41834418
767,tt0435651,The Giver,97.0,"Drama,Romance,Sci-Fi","Aug 15, 2014",25000000,45090374,66540205,41540205
768,tt2224349,My Girl,,Drama,"Nov 27, 1991",16500000,58011485,58011485,41511485
771,tt1465490,Joy,75.0,Drama,"Dec 25, 2015",60000000,56451232,101134059,41134059
772,tt2011159,No Good Deed,84.0,"Action,Crime,Drama","Sep 12, 2014",13200000,52543632,54323210,41123210
773,tt5052474,Sicario: Day of the Soldado,122.0,"Action,Crime,Drama","Jun 29, 2018",35000000,50065850,75885196,40885196
774,tt1072748,Winchester,99.0,"Biography,Drama,Fantasy","Feb 2, 2018",3500000,25091816,44378040,40878040
775,tt1391137,Why Did I Get Married Too?,121.0,"Comedy,Drama,Romance","Apr 2, 2010",20000000,60095852,60831067,40831067
777,tt4999290,Remember Me,,"Comedy,Drama,Romance","Mar 12, 2010",16000000,19068240,56506120,40506120
778,tt2671706,Fences,139.0,Drama,"Dec 16, 2016",24000000,57682904,64282881,40282881
785,tt6760504,Sea of Love,47.0,"Drama,Mystery,Romance","Sep 15, 1989",19000000,58571513,58571513,39571513
787,tt1655441,The Age of Adaline,112.0,"Drama,Fantasy,Romance","Apr 24, 2015",30000000,42629776,68984536,38984536
790,tt3581652,West Side Story,,"Crime,Drama,Musical","Oct 18, 1961",6000000,43700000,43700000,37700000
792,tt1615065,Savages,131.0,"Crime,Drama,Thriller","Jul 6, 2012",45000000,47323100,82513490,37513490
798,tt1458175,The Next Three Days,133.0,"Action,Crime,Drama","Nov 19, 2010",30000000,21148651,67255916,37255916
799,tt1582507,House at the End of the Street,101.0,"Drama,Horror,Thriller","Sep 21, 2012",6900000,31611916,44103982,37203982
805,tt2053463,Side Effects,106.0,"Crime,Drama,Mystery","Feb 8, 2013",30000000,32172757,66742138,36742138
806,tt3316960,Still Alice,101.0,Drama,"Jan 16, 2015",5000000,18656400,41699612,36699612
808,tt1265990,The Roommate,91.0,"Drama,Thriller","Feb 4, 2011",16000000,37300107,52545707,36545707
810,tt3722070,The Lady in the Van,104.0,"Biography,Comedy,Drama","Jan 15, 2016",6000000,10021175,42320503,36320503
811,tt2005151,War Dogs,114.0,"Comedy,Crime,Drama","Aug 19, 2016",50000000,43034523,86234503,36234503
812,tt1413492,12 Strong,130.0,"Action,Drama,History","Jan 19, 2018",35000000,45819713,71118378,36118378
813,tt2229499,Don Jon,90.0,"Comedy,Drama,Romance","Sep 27, 2013",5500000,24477704,41268579,35768579
814,tt1826727,Life of the Party,84.0,"Comedy,Drama","May 11, 2018",30000000,53059911,65759911,35759911
816,tt2582802,Whiplash,106.0,"Drama,Music","Oct 10, 2014",3300000,13092006,38969037,35669037
818,tt1586713,Burlesque,,Drama,"Nov 24, 2010",55000000,39440655,90552675,35552675
821,tt0993842,Hanna,111.0,"Action,Drama,Thriller","Apr 8, 2011",30000000,40259119,65343694,35343694
822,tt2039338,Flatliners,109.0,"Drama,Horror,Mystery","Aug 10, 1990",26000000,61308153,61308153,35308153
827,tt3281548,Little Women,,"Drama,Romance","Dec 21, 1994",15000000,50003303,50003303,35003303
828,tt2607640,Fortress,70.0,"Documentary,Drama,News","Sep 3, 1993",12000000,6730578,46730578,34730578
829,tt3628584,Barbershop: The Next Cut,111.0,"Comedy,Drama","Apr 15, 2016",20000000,54030051,54404202,34404202
831,tt0365907,A Walk Among the Tombstones,114.0,"Action,Crime,Drama","Sep 19, 2014",28000000,26017685,62108587,34108587
833,tt4218572,Widows,129.0,"Crime,Drama,Thriller","Nov 16, 2018",40000000,42402632,73866088,33866088
839,tt2385003,Assassins,84.0,"Action,Drama,Thriller","Oct 6, 1995",50000000,30306268,83306268,33306268
840,tt1630036,Courageous,129.0,Drama,"Sep 30, 2011",2000000,34522221,35185884,33185884
841,tt1657507,Colombiana,108.0,"Action,Drama,Thriller","Aug 26, 2011",40000000,36665854,72295262,32295262
842,tt0842926,The Kids Are All Right,106.0,"Comedy,Drama,Romance","Jul 9, 2010",4000000,20811365,36275469,32275469
844,tt1817273,The Place Beyond the Pines,140.0,"Crime,Drama,Thriller","Mar 29, 2013",15000000,21403519,47011449,32011449
847,tt1583420,Larry Crowne,98.0,"Comedy,Drama,Romance","Jul 1, 2011",30000000,35608245,61449135,31449135
850,tt4064912,Shine,95.0,"Drama,Music","Nov 22, 1996",5500000,35811509,36672493,31172493
851,tt1640484,Jumping the Broom,112.0,"Comedy,Drama","May 6, 2011",7000000,37295394,38158601,31158601
852,tt1799516,Benji,87.0,"Crime,Drama,Family","Nov 15, 1974",500000,31559560,31559560,31059560
853,tt2402927,Carol,118.0,"Drama,Romance","Nov 20, 2015",11800000,12711491,42843521,31043521
855,tt0889573,The Switch,101.0,"Comedy,Drama,Romance","Aug 20, 2010",19000000,27758465,49858465,30858465
859,tt3258802,The Game,,Drama,"Sep 12, 1997",50000000,48265581,80369970,30369970
861,tt7186036,Volcano,104.0,"Comedy,Drama","Apr 25, 1997",90000000,47546796,120100000,30100000
862,tt0491152,Something Borrowed,112.0,"Comedy,Drama,Romance","May 6, 2011",35000000,39046489,65084116,30084116
865,tt4481414,Gifted,101.0,Drama,"Apr 7, 2017",7000000,24801212,36964656,29964656
868,tt1661382,Grudge Match,113.0,"Comedy,Drama,Sport","Dec 25, 2013",40000000,29807260,69807260,29807260
869,tt2726560,The Longest Ride,123.0,"Drama,Romance","Apr 10, 2015",34000000,37446117,63802928,29802928
871,tt4767526,Coming Home,88.0,Drama,"Jan 1, 1978",3000000,32653000,32653000,29653000
874,tt1787759,Madea's Big Happy Family,106.0,"Comedy,Drama","Apr 22, 2011",25000000,53345287,54160818,29160818
875,tt1596346,Soul Surfer,112.0,"Biography,Drama,Family","Apr 8, 2011",18000000,43853424,47158652,29158652
881,tt2952692,State of Play,87.0,"Documentary,Drama,Sport","Apr 17, 2009",60000000,37017955,88832210,28832210
882,tt2097298,"McFarland, USA",129.0,"Biography,Drama,Sport","Feb 20, 2015",17000000,44480275,45707924,28707924
884,tt1371111,Cloud Atlas,172.0,"Action,Drama,Mystery","Oct 26, 2012",102000000,27108272,130673154,28673154
888,tt1921064,Pompeii,105.0,"Action,Adventure,Drama","Feb 21, 2014",80000000,23169033,108469033,28469033
895,tt1619029,Jackie,100.0,"Biography,Drama,History","Dec 2, 2016",9000000,13960394,36588512,27588512
898,tt1602620,Amour,127.0,"Drama,Romance","Dec 19, 2012",9700000,6738954,36787044,27087044
899,tt4136084,Florence Foster Jenkins,111.0,"Biography,Comedy,Drama","Aug 12, 2016",29000000,27383770,56000339,27000339
901,tt6850820,Peppermint,101.0,"Action,Crime,Drama","Sep 7, 2018",25000000,35418723,51800758,26800758
903,tt6063050,Acrimony,120.0,"Drama,Romance,Thriller","Mar 30, 2018",20000000,43549096,46627836,26627836
904,tt2698966,The Debt,99.0,"Drama,Mystery,Thriller","Aug 31, 2011",20000000,31177548,46604054,26604054
905,tt3488710,The Walk,123.0,"Adventure,Biography,Drama","Sep 30, 2015",35000000,10161183,61492104,26492104
906,tt3231054,Risen,107.0,"Action,Adventure,Drama","Feb 19, 2016",20000000,36880033,46255763,26255763
907,tt2101441,Spring Breakers,94.0,"Comedy,Crime,Drama","Mar 15, 2013",5000000,14124286,31149251,26149251
909,tt6802308,The 15:17 to Paris,94.0,"Biography,Drama,Thriller","Feb 9, 2018",30000000,36276286,56096200,26096200
912,tt1322269,August: Osage County,121.0,"Comedy,Drama","Dec 25, 2013",25000000,37738810,50738810,25738810
913,tt2582782,Hell or High Water,102.0,"Action,Crime,Drama","Aug 12, 2016",12000000,27007844,37584304,25584304
914,tt4649416,Almost Christmas,111.0,"Comedy,Drama","Nov 11, 2016",17000000,42065185,42493506,25493506
915,tt2357129,Jobs,128.0,"Biography,Drama","Aug 16, 2013",18000000,16131410,43402515,25402515
916,tt1028576,Secretariat,123.0,"Biography,Drama,Family","Oct 8, 2010",35000000,59699513,60376247,25376247
917,tt0470752,Ex Machina,108.0,"Drama,Mystery,Sci-Fi","Apr 10, 2015",13000000,25440971,38358392,25358392
918,tt1742044,Jersey Boys,134.0,"Biography,Drama,Music","Jun 20, 2014",40000000,47047013,65282732,25282732
919,tt1798709,Her,126.0,"Drama,Romance,Sci-Fi","Jan 10, 2014",23000000,25568251,48163815,25163815
924,tt1754656,The Little Prince,108.0,"Adventure,Animation,Drama","Feb 12, 2016",77500000,1311213,102028919,24528919
927,tt7379226,Awake,84.0,Drama,"Nov 30, 2007",8600000,14373825,32968648,24368648
929,tt1655420,My Week with Marilyn,99.0,"Biography,Drama","Nov 23, 2011",10000000,14597405,34240572,24240572
935,tt10152772,Cobra,,Drama,"May 23, 1986",25000000,49042224,49042224,24042224
937,tt1764183,Arbitrage,107.0,"Drama,Thriller","Sep 14, 2012",12000000,7919574,35830713,23830713
939,tt4030600,The Bye Bye Man,96.0,"Drama,Fantasy,Horror","Jan 13, 2017",7400000,22395806,31187727,23787727
940,tt1691149,Saving Grace,85.0,"Crime,Drama,Horror","Aug 4, 2000",4000000,12178602,27786849,23786849
944,tt3170832,Room,118.0,"Drama,Thriller","Oct 16, 2015",13000000,14677674,36262783,23262783
945,tt3623726,Ricki and the Flash,101.0,"Comedy,Drama,Music","Aug 7, 2015",18000000,26839498,41166033,23166033
948,tt2168766,Adrift,,Drama,"Jun 1, 2018",35000000,31445011,57897191,22897191
950,tt1226273,Edge of Darkness,117.0,"Crime,Drama,Mystery","Jan 29, 2010",60000000,43313890,82812456,22812456
951,tt4287320,The Circle,110.0,"Drama,Sci-Fi,Thriller","Apr 28, 2017",18000000,20497844,40651864,22651864
954,tt2057392,Eye in the Sky,102.0,"Drama,Thriller,War","Mar 11, 2016",13000000,18704596,35402802,22402802
955,tt2121286,Home Again,104.0,Drama,"Sep 8, 2017",15000000,27020284,37336874,22336874
958,tt1083452,Eddie the Eagle,106.0,"Biography,Comedy,Drama","Feb 26, 2016",23000000,15789389,45060480,22060480
959,tt2042568,Inside Llewyn Davis,104.0,"Drama,Music","Dec 6, 2013",11000000,13248209,32943247,21943247
961,tt1727388,The Way Way Back,103.0,"Comedy,Drama","Jul 5, 2013",5000000,21502690,26853810,21853810
962,tt2978462,Dolphin Tale 2,107.0,"Drama,Family","Sep 12, 2014",36000000,42024533,57824533,21824533
963,tt4768504,Quo Vadis?,45.0,"Drama,Romance","Feb 23, 1951",8250000,30000000,30028513,21778513
964,tt1555069,Mary Queen of Scots,119.0,"Biography,Drama,History","Dec 7, 2018",25000000,16468499,46734733,21734733
965,tt2514592,Mud,105.0,Drama,"Apr 26, 2013",10000000,21590086,31556959,21556959
968,tt2125435,Beasts of the Southern Wild,93.0,"Adventure,Drama,Fantasy","Jun 27, 2012",1800000,12795746,23265132,21465132
969,tt2034139,The Last Exorcism Part II,88.0,"Drama,Horror,Thriller","Mar 1, 2013",4000000,15179303,25448707,21448707
970,tt4698684,Hunt for the Wilderpeople,101.0,"Adventure,Comedy,Drama","Jun 24, 2016",2500000,5205471,23845533,21345533
974,tt5161028,The Family,106.0,"Documentary,Drama","Sep 13, 2013",30000000,36918811,51078541,21078541
975,tt1972571,A Most Wanted Man,122.0,"Crime,Drama,Thriller","Jul 25, 2014",15000000,17237855,36068890,21068890
976,tt1152398,Beastly,86.0,"Drama,Fantasy,Romance","Mar 4, 2011",17000000,27865571,38028230,21028230
977,tt2436386,Project Almanac,106.0,"Drama,Mystery,Sci-Fi","Jan 30, 2015",12000000,22348241,32909437,20909437
979,tt1637706,Our Idiot Brother,90.0,"Comedy,Drama","Aug 26, 2011",5000000,24814830,25861249,20861249
980,tt1389139,When the Bough Breaks,107.0,"Crime,Drama,Horror","Sep 9, 2016",10000000,29747603,30768449,20768449
982,tt3253430,Waitress,,Drama,"May 2, 2007",1500000,19097550,22217183,20717183
984,tt2071441,Dangerous Liaisons,110.0,"Drama,Mystery,Romance","Dec 21, 1988",14000000,34700000,34700000,20700000
987,tt1139328,The Ghost Writer,128.0,"Drama,Mystery,Thriller","Feb 19, 2010",45000000,15541549,65532491,20532491
988,tt7388562,"Paul, Apostle of Christ",108.0,"Adventure,Biography,Drama","Mar 23, 2018",5000000,17547999,25529498,20529498
989,tt2675102,Brown Sugar,120.0,Drama,"Oct 11, 2002",8000000,27362712,28315272,20315272
990,tt2209418,Before Midnight,109.0,"Drama,Romance","May 24, 2013",3000000,8110621,23251930,20251930
992,tt1659337,The Perks of Being a Wallflower,103.0,Drama,"Sep 21, 2012",13000000,17742948,33069303,20069303
993,tt3077214,Suffragette,106.0,"Biography,Drama,History","Oct 23, 2015",14000000,4702420,34044909,20044909
994,tt2554274,Crimson Peak,119.0,"Drama,Fantasy,Horror","Oct 16, 2015",55000000,31090320,74966854,19966854
995,tt5057746,Network,140.0,"Drama,Thriller","Jan 1, 1976",3800000,23689877,23689877,19889877
997,tt1126618,Morning Glory,107.0,"Comedy,Drama,Romance","Nov 10, 2010",40000000,31011732,59795070,19795070
999,tt5566714,Hawaii,116.0,Drama,"Oct 10, 1966",15000000,34562222,34562222,19562222
1003,tt1182350,You Will Meet a Tall Dark Stranger,98.0,"Comedy,Drama,Romance","Sep 22, 2010",15000000,3247816,34247816,19247816
1005,tt6314294,Brothers,93.0,Drama,"Dec 4, 2009",26000000,28544157,45043870,19043870
1009,tt3499096,Race,134.0,"Biography,Drama,Sport","Feb 19, 2016",5000000,19115191,23745772,18745772
1010,tt3521126,The Disaster Artist,104.0,"Biography,Comedy,Drama","Dec 1, 2017",10000000,21120616,28717667,18717667
1012,tt1137450,Death Wish,107.0,"Action,Crime,Drama","Mar 2, 2018",30000000,34017028,48575965,18575965
1015,tt4291590,Evolution,81.0,"Drama,Mystery,Sci-Fi","Jun 8, 2001",80000000,38311134,98341932,18341932
1016,tt8774508,The Last Stand,93.0,Drama,"Jan 18, 2013",30000000,12050299,48330757,18330757
1020,tt4669788,On the Basis of Sex,120.0,"Biography,Drama","Dec 25, 2018",20000000,24622687,38073377,18073377
1024,tt2390361,Enough Said,93.0,"Comedy,Drama,Romance","Sep 18, 2013",8000000,17550872,25621449,17621449
1027,tt3555036,Legend,168.0,"Action,Drama","Nov 20, 2015",25000000,1872994,42425450,17425450
1028,tt1126590,Big Eyes,106.0,"Biography,Crime,Drama","Dec 25, 2014",10000000,14482031,27317872,17317872
1029,tt9109976,Psycho,,"Drama,Thriller","Dec 4, 1998",20000000,21541218,37226218,17226218
1032,tt1615147,Margin Call,107.0,"Drama,Thriller","Oct 21, 2011",3400000,5353586,20433227,17033227
1033,tt1405500,For Colored Girls,133.0,Drama,"Nov 5, 2010",21000000,37729698,38017873,17017873
1035,tt2199571,Run All Night,114.0,"Action,Drama,Thriller","Mar 13, 2015",50000000,26461644,66961644,16961644
1036,tt4607118,Burnt,,"Comedy,Drama","Oct 30, 2015",20000000,13651946,36773510,16773510
1037,tt2334649,Fruitvale Station,85.0,"Biography,Drama,Romance","Jul 12, 2013",900000,16098998,17549645,16649645
1038,tt2927802,Superstar,,Drama,"Oct 8, 1999",14000000,30628981,30628981,16628981
1046,tt1931435,The Big Wedding,89.0,"Comedy,Drama,Romance","Apr 26, 2013",32500000,21819348,48425971,15925971
1048,tt10065960,Snatched,11.0,Drama,"May 12, 2017",42000000,45852178,57852177,15852177
1051,tt2033424,The Outsiders,110.0,Drama,"Mar 25, 1983",10000000,25697647,25697647,15697647
1052,tt4105466,War,106.0,Drama,"Aug 24, 2007",25000000,22486409,40686409,15686409
1053,tt1120985,Blue Valentine,112.0,"Drama,Romance","Dec 29, 2010",1000000,9737892,16566240,15566240
1055,tt2296697,Concussion,96.0,Drama,"Dec 25, 2015",35000000,34531832,50363790,15363790
1057,tt5439796,Logan Lucky,118.0,"Comedy,Crime,Drama","Aug 18, 2017",29000000,27778642,44264271,15264271
1058,tt1462769,The Odd Life of Timothy Green,105.0,"Comedy,Drama,Family","Aug 15, 2012",40000000,51853450,55249159,15249159
1061,tt1883160,The Visitor,70.0,"Drama,Romance","Apr 11, 2008",4000000,9427026,19174817,15174817
1063,tt2247476,When the Game Stands Tall,115.0,"Drama,Family,Sport","Aug 22, 2014",15000000,30127963,30138912,15138912
1065,tt1972779,The Best of Me,118.0,"Drama,Romance","Oct 17, 2014",26000000,26766213,41059418,15059418
1069,tt2318092,Endless Love,104.0,"Drama,Romance","Feb 14, 2014",20000000,23438250,34718173,14718173
1070,tt1876451,Sparkle,116.0,"Drama,Music","Aug 17, 2012",10000000,24397469,24660323,14660323
1071,tt1767382,Silent House,86.0,"Drama,Horror,Mystery","Mar 9, 2012",2000000,12739737,16610760,14610760
1072,tt1651918,Nighthawks,102.0,Drama,"Apr 10, 1981",5000000,14600000,19600000,14600000
1073,tt2651158,Much Ado About Nothing,167.0,"Comedy,Drama","May 7, 1993",8000000,22549338,22549338,14549338
1077,tt3252624,The Watcher,75.0,Drama,"Sep 8, 2000",33000000,28946615,47267829,14267829
1078,tt1647668,Million Dollar Arm,124.0,"Biography,Drama,Sport","May 16, 2014",25000000,36447959,39217912,14217912
1080,tt1399683,Winter's Bone,100.0,"Drama,Mystery","Jun 11, 2010",2000000,6531503,16131551,14131551
1083,tt1034389,The Eagle,114.0,"Action,Adventure,Drama","Feb 11, 2011",25000000,19490041,38993548,13993548
1084,tt1691916,Before I Fall,98.0,"Drama,Fantasy,Mystery","Mar 3, 2017",5000000,12241072,18945682,13945682
1086,tt3009444,Shame,90.0,Drama,"Dec 2, 2011",6500000,4002293,20412841,13912841
1088,tt1661420,Polisse,127.0,"Crime,Drama","May 18, 2012",8900000,176988,22744132,13844132
1093,tt1537401,Leap Year,94.0,"Drama,Romance","Jan 8, 2010",19000000,25918920,32618920,13618920
1094,tt4955062,Jack,97.0,"Crime,Drama","Aug 9, 1996",45000000,58617334,58617334,13617334
1097,tt6739824,Upgrade,,Drama,"Jun 1, 2018",3000000,11977130,16553285,13553285
1099,tt3464902,The Lobster,119.0,"Comedy,Drama,Romance","Mar 25, 2016",4500000,9196278,18019834,13519834
1100,tt1506999,Haywire,93.0,"Action,Drama,Thriller","Jan 20, 2012",23000000,18942396,36374700,13374700
1101,tt3640424,Allied,124.0,"Action,Drama,Romance","Nov 23, 2016",106000000,40098064,119266661,13266661
1105,tt2883434,Black or White,121.0,Drama,"Jan 30, 2015",9000000,21571189,21971021,12971021
1106,tt8382238,Enough,,Drama,"May 24, 2002",38000000,39177215,50970660,12970660
1110,tt4103724,Forever My Girl,108.0,"Drama,Music,Romance","Jan 19, 2018",3500000,16376066,16376066,12876066
1112,tt4572514,Patriots Day,133.0,"Action,Crime,Drama","Dec 21, 2016",40000000,31886361,52837989,12837989
1113,tt1821549,Nebraska,115.0,"Adventure,Comedy,Drama","Nov 15, 2013",12000000,17654912,24761360,12761360
1114,tt7153766,Unsane,98.0,"Drama,Horror,Mystery","Mar 23, 2018",1500000,7690044,14244931,12744931
1115,tt8325050,Baby Boy,,Drama,"Jun 27, 2001",16000000,28734552,28734552,12734552
1116,tt2718492,Ida,82.0,Drama,"May 2, 2014",2600000,3827060,15298355,12698355
1117,tt5152894,Mommy,135.0,Drama,"Jan 23, 2015",4900000,3498695,17536004,12636004
1119,tt1741273,Secret in Their Eyes,111.0,"Crime,Drama,Mystery","Nov 20, 2015",20000000,20180155,32608019,12608019
1123,tt5797456,Melancholia,75.0,"Drama,Mystery,Romance","Nov 11, 2011",9400000,3030848,21817298,12417298
1124,tt7014006,Eighth Grade,93.0,"Comedy,Drama","Jul 13, 2018",2000000,13539710,14341016,12341016
1125,tt2910904,The Dressmaker,119.0,"Comedy,Drama","Sep 23, 2016",11900000,2022115,24041617,12141617
1127,tt9024106,Unplanned,106.0,"Biography,Drama","Mar 29, 2019",6000000,18107621,18107621,12107621
1128,tt5580266,The Hate U Give,133.0,"Crime,Drama","Oct 5, 2018",23000000,29719483,35067665,12067665
1130,tt3508808,Another Year,107.0,"Drama,Romance","Dec 29, 2010",8000000,3205706,20005613,12005613
1131,tt4056738,Do You Believe?,120.0,Drama,"Mar 20, 2015",2300000,12985600,14304931,12004931
1134,tt1433108,Faster,98.0,"Action,Crime,Drama","Nov 24, 2010",24000000,23240020,35792945,11792945
1135,tt7106782,The Namesake,77.0,Drama,"Mar 9, 2007",8500000,13610521,20288774,11788774
1138,tt5322012,Wish Upon,90.0,"Drama,Fantasy,Horror","Jul 14, 2017",12000000,14301505,23477345,11477345
1139,tt9392082,Magnolia,49.0,"Drama,Music","Dec 17, 1999",37000000,22450975,48446802,11446802
1140,tt1673697,The Sapphires,103.0,"Biography,Comedy,Drama","Mar 22, 2013",9000000,2450867,20395040,11395040
1141,tt3850214,Dope,103.0,"Comedy,Crime,Drama","Jun 19, 2015",7000000,17506470,18190831,11190831
1142,tt2473794,Mr. Turner,150.0,"Biography,Drama,History","Dec 19, 2014",14000000,3958546,25187026,11187026
1143,tt1532503,Beginners,105.0,"Comedy,Drama,Romance","Jun 3, 2011",3200000,5790894,14314407,11114407
1144,tt3312830,Youth,124.0,"Comedy,Drama,Music","Dec 4, 2015",13000000,2703296,24001573,11001573
1145,tt2172934,3 Days to Kill,117.0,"Action,Drama,Thriller","Feb 21, 2014",28000000,30697999,38959900,10959900
1146,tt4196450,The Birth of a Nation,120.0,"Biography,Drama,History","Feb 8, 1915",110000,10000000,11000000,10890000
1147,tt6266538,Vice,132.0,"Biography,Comedy,Drama","Dec 25, 2018",60000000,47836282,70883171,10883171
1149,tt1625346,Young Adult,94.0,"Comedy,Drama","Dec 9, 2011",12000000,16311571,22750356,10750356
1152,tt2350496,The Lunchbox,104.0,"Drama,Romance","Feb 28, 2014",1700000,4231500,12231500,10531500
1154,tt1866249,The Sessions,95.0,"Biography,Comedy,Drama","Oct 19, 2012",1000000,6002451,11495204,10495204
1156,tt1840417,The Words,102.0,"Drama,Mystery,Romance","Sep 7, 2012",6000000,11494838,16369708,10369708
1157,tt3264438,She's the One,110.0,"Drama,Romance","Aug 23, 1996",3500000,9482579,13795053,10295053
1158,tt1559547,Beautiful Creatures,124.0,"Drama,Fantasy,Romance","Feb 14, 2013",50000000,19452138,60282876,10282876
1162,tt1878870,The Edge of Seventeen,104.0,"Comedy,Drama","Nov 18, 2016",9000000,14431633,19096003,10096003
1163,tt1421051,Somewhere,97.0,"Comedy,Drama","Dec 22, 2010",7000000,1785645,17023121,10023121
1166,tt4550098,Nocturnal Animals,116.0,"Drama,Thriller","Nov 18, 2016",22500000,10663357,32398681,9898681
1167,tt1666185,All Eyez on Me,139.0,"Biography,Drama,Music","Jun 16, 2017",45000000,44922302,54876855,9876855
1168,tt3257168,Shorts,95.0,Drama,"Aug 21, 2009",20000000,20919166,29870801,9870801
1170,tt4161036,Pulse,84.0,"Drama,Fantasy,Sci-Fi","Aug 11, 2006",20500000,20264436,30241435,9741435
1176,tt4276820,The Founder,115.0,"Biography,Drama,History","Jan 20, 2017",15000000,12786053,24403192,9403192
1177,tt3606888,A Street Cat Named Bob,103.0,"Biography,Comedy,Drama","Nov 18, 2016",8000000,82703,17382693,9382693
1178,tt1728200,The Box,89.0,Drama,"Nov 6, 2009",25000000,15051977,34356760,9356760
1179,tt5649144,The Florida Project,111.0,Drama,"Oct 6, 2017",2000000,5904366,11295324,9295324
1180,tt1255953,Incendies,131.0,"Drama,Mystery,War","Sep 17, 2010",6800000,6857096,16038343,9238343
1181,tt4133310,Bella,80.0,"Drama,Family","Oct 26, 2007",3300000,8093373,12405473,9105473
1182,tt4895740,Frenzy,119.0,Drama,"Jun 21, 1972",3500000,12600000,12600000,9100000
1184,tt2316649,Frailty,,Drama,"Apr 12, 2002",11000000,13110448,19947280,8947280
1185,tt7895868,Secrets & Lies,,"Drama,Romance","Sep 28, 1996",4500000,13417292,13417292,8917292
1186,tt6619272,The Contender,74.0,"Documentary,Drama,Sport","Oct 13, 2000",9000000,17804273,17804273,8804273
1190,tt5937296,Glory,101.0,Drama,"Dec 13, 1989",18000000,26593580,26593580,8593580
1191,tt3007512,The Water Diviner,111.0,"Drama,History,War","Apr 24, 2015",22500000,4200117,31054727,8554727
1196,tt2347569,Frances Ha,86.0,"Comedy,Drama,Romance","May 17, 2013",3000000,4067398,11262769,8262769
1198,tt2321163,ABCD (Any Body Can Dance),160.0,"Drama,Music","Feb 8, 2013",1900000,222098,10137234,8237234
1199,tt1758810,The Snowman,119.0,"Crime,Drama,Mystery","Oct 20, 2017",35000000,6670765,43226146,8226146
1201,tt3787590,We Are Your Friends,96.0,"Drama,Music,Romance","Aug 28, 2015",2000000,3591417,10153415,8153415
1202,tt1508675,Le Havre,93.0,"Comedy,Drama","Oct 21, 2011",5500000,611709,13480196,7980196
1203,tt1198101,Kites,123.0,"Action,Drama,Romance","May 21, 2010",9200000,1685269,17155193,7955193
1204,tt3566920,The Other Side of the Door,90.0,Drama,"Mar 4, 2016",5000000,3000342,12905107,7905107
1205,tt7125860,If Beale Street Could Talk,119.0,"Drama,Romance","Dec 14, 2018",12000000,14915773,19859167,7859167
1210,tt3215846,Dreamcatcher,104.0,"Crime,Documentary,Drama","Mar 21, 2003",68000000,33685268,75685268,7685268
1211,tt1371155,Made in Dagenham,113.0,"Biography,Comedy,Drama","Nov 19, 2010",8000000,1095369,15644196,7644196
1213,tt3125324,Beyond the Lights,116.0,"Drama,Music,Romance","Nov 14, 2014",7000000,14618727,14618727,7618727
1215,tt4080028,Thirteen,100.0,Drama,"Aug 20, 2003",2000000,4601043,9505996,7505996
1216,tt1791682,While We're Young,97.0,"Comedy,Drama,Mystery","Mar 27, 2015",10000000,7582065,17503828,7503828
1219,tt3014866,Criminal,113.0,"Action,Crime,Drama","Apr 15, 2016",31500000,14708696,38771262,7271262
1224,tt7967412,Eye for an Eye,,Drama,"Jan 12, 1996",20000000,26792700,26792700,6792700
1227,tt1600196,The Drop,106.0,"Crime,Drama","Sep 12, 2014",12600000,10724389,19054534,6454534
1228,tt1618430,Dum Maaro Dum,128.0,"Action,Crime,Drama","Apr 22, 2011",5200000,564489,11633427,6433427
1233,tt2058107,The Railway Man,116.0,"Biography,Drama,Romance","Apr 11, 2014",18000000,4438438,23910210,5910210
1236,tt9805168,Traitor,110.0,"Action,Drama,Romance","Aug 27, 2008",22000000,23530831,27882226,5882226
1239,tt1814621,Admission,107.0,"Comedy,Drama,Romance","Mar 22, 2013",13000000,18007317,18733666,5733666
1240,tt5247022,Paterson,118.0,"Comedy,Drama,Romance","Dec 28, 2016",5000000,2141423,10727536,5727536
1242,tt1555064,Country Strong,117.0,"Drama,Music","Dec 22, 2010",15000000,20218921,20601987,5601987
1244,tt2080374,Steve Jobs,122.0,"Biography,Drama","Oct 9, 2015",30000000,17766658,35579007,5579007
1247,tt1951212,Out of Time,98.0,"Drama,Mystery,Thriller","Oct 3, 2003",50000000,41083108,55489826,5489826
1248,tt2321549,The Babadook,94.0,"Drama,Horror","Nov 28, 2014",2000000,950792,7482387,5482387
1251,tt1541995,Snow Flower and the Secret Fan,104.0,"Drama,History","Jul 15, 2011",6000000,1348205,11348205,5348205
1253,tt1366338,Lowriders,98.0,"Adventure,Crime,Drama","May 12, 2017",916000,6179955,6188421,5272421
1254,tt7201536,Chain Reaction,100.0,Drama,"Aug 2, 1996",55000000,21226204,60209334,5209334
1256,tt8254042,Monsters,97.0,"Drama,Thriller","Oct 29, 2010",500000,237301,5639730,5139730
1257,tt1320291,The Reef,94.0,"Adventure,Drama,Horror","Dec 31, 2010",10000000,0,15037867,5037867
1258,tt3746918,The Losers,112.0,Drama,"Apr 23, 2010",25000000,23591432,29863840,4863840
1259,tt2223990,Draft Day,110.0,"Drama,Sport","Apr 11, 2014",25000000,28842237,29847480,4847480
1260,tt1571249,The Skeleton Twins,93.0,"Comedy,Drama,Romance","Sep 12, 2014",1000000,5284309,5797192,4797192
1261,tt5970386,Left Behind,24.0,"Documentary,Drama","Oct 3, 2014",16000000,14019924,20769209,4769209
1263,tt4828926,Rebecca,85.0,"Drama,Romance","Mar 21, 1940",1288000,6000000,6002370,4714370
1264,tt4975920,The Kid,100.0,"Biography,Drama,Western","Jul 7, 2000",65000000,69688384,69688384,4688384
1266,tt1438254,Charlie St. Cloud,99.0,"Drama,Fantasy,Romance","Jul 30, 2010",44000000,31206263,48478084,4478084
1268,tt1441326,Martha Marcy May Marlene,102.0,"Drama,Mystery,Thriller","Oct 21, 2011",1000000,2981038,5438911,4438911
1269,tt1714206,The Spectacular Now,95.0,"Comedy,Drama,Romance","Aug 2, 2013",2500000,6852971,6916951,4416951
1270,tt1720182,October Baby,107.0,Drama,"Mar 23, 2012",1000000,5355847,5391992,4391992
1272,tt4073790,The Darkest Minds,104.0,"Action,Adventure,Drama","Aug 3, 2018",34000000,12695691,38361428,4361428
1275,tt3749926,Bug,95.0,"Drama,Mystery,Thriller","May 25, 2007",4000000,7006708,8302995,4302995
1277,tt3386948,Let There Be Light,52.0,"Biography,Documentary,Drama","Oct 27, 2017",3000000,7233471,7241309,4241309
1281,tt2235108,Dear White People,108.0,"Comedy,Drama,Romance","Oct 17, 2014",1250000,4404154,5403771,4153771
1282,tt3966404,Mustang,97.0,Drama,"Nov 20, 2015",1400000,845464,5552584,4152584
1285,tt4663548,All Saints,108.0,Drama,"Aug 25, 2017",2000000,5802208,5941994,3941994
1286,tt5479616,Loving,105.0,"Drama,Romance","Nov 4, 2016",9000000,7710234,12898064,3898064
1287,tt1313092,Animal Kingdom,113.0,"Crime,Drama","Aug 13, 2010",4200000,1044039,8078683,3878683
1288,tt10227710,Brick,93.0,"Drama,Family,Romance","Mar 31, 2006",450000,2075743,4243996,3793996
1289,tt1242460,We Need to Talk About Kevin,112.0,"Drama,Mystery,Thriller","Jan 13, 2012",7000000,1738692,10765283,3765283
1291,tt4573516,Sleight,89.0,"Action,Drama,Sci-Fi","Apr 28, 2017",250000,3930990,3934450,3684450
1292,tt1862079,Safety Not Guaranteed,86.0,"Comedy,Drama,Romance","Jun 8, 2012",750000,4010957,4422318,3672318
1293,tt1710396,Joyful Noise,118.0,"Comedy,Drama,Music","Jan 13, 2012",27500000,30932113,31157914,3657914
1295,tt0857190,The Sweeney,112.0,"Action,Crime,Drama","Mar 1, 2013",4500000,26345,8000366,3500366
1296,tt4621872,Like Crazy,116.0,"Comedy,Drama","Oct 28, 2011",250000,3395391,3728400,3478400
1297,tt3416532,A Monster Calls,108.0,"Animation,Drama,Fantasy","Jan 6, 2017",43000000,3740823,46414530,3414530
1298,tt2006295,The 33,127.0,"Biography,Drama,History","Nov 13, 2015",25000000,12227722,28400715,3400715
1299,tt2473602,Get on Up,139.0,"Biography,Drama,Music","Aug 1, 2014",30000000,30569935,33339868,3339868
1300,tt6599032,Lost Souls,84.0,"Action,Drama","Oct 13, 2000",28000000,16779636,31320293,3320293
1302,tt1321511,Oldboy,104.0,"Action,Drama,Mystery","Mar 25, 2005",3000000,707391,6239723,3239723
1304,tt4224638,Before Sunrise,70.0,Drama,"Jan 27, 1995",2500000,5274005,5690220,3190220
1310,tt1742336,Your Sister's Sister,90.0,"Comedy,Drama","Jun 15, 2012",120000,1597486,3090593,2970593
1311,tt4034354,Swiss Army Man,97.0,"Adventure,Comedy,Drama","Jun 24, 2016",3000000,4210454,5837111,2837111
1313,tt1604171,Prom,104.0,"Comedy,Drama,Family","Apr 29, 2011",8000000,10130219,10763183,2763183
1314,tt3458776,Happiness,80.0,"Documentary,Drama,Family","Oct 16, 1998",3000000,2746453,5746453,2746453
1315,tt3882396,Irreversible,100.0,Drama,"Mar 7, 2003",5400000,792200,8133256,2733256
1318,tt1440292,Submarine,97.0,"Comedy,Drama,Romance","Jun 3, 2011",1900000,467602,4581937,2681937
1319,tt6265828,A Ghost Story,92.0,"Drama,Fantasy,Romance","Jul 7, 2017",100000,1594798,2769782,2669782
1320,tt3212738,Hostage,97.0,"Comedy,Drama,History","Mar 11, 2005",75000000,34636443,77636443,2636443
1322,tt5719748,Cold Pursuit,119.0,"Action,Crime,Drama","Feb 8, 2019",60000000,32138862,62599159,2599159
1323,tt6122702,Bound,,Drama,"Oct 4, 1996",4500000,3802260,7011317,2511317
1324,tt1727497,Control,127.0,"Action,Crime,Drama","Oct 10, 2007",6400000,871577,8902141,2502141
1326,tt1990314,Robot & Frank,89.0,"Comedy,Crime,Drama","Aug 17, 2012",2500000,3317468,4934356,2434356
1327,tt0787524,The Man Who Knew Infinity,108.0,"Biography,Drama","Apr 29, 2016",10000000,3877922,12382122,2382122
1328,tt4501454,The Meddler,103.0,"Comedy,Drama,Romance","Apr 22, 2016",3200000,4267219,5526942,2326942
1329,tt2910274,Obvious Child,84.0,"Comedy,Drama,Romance","Jun 6, 2014",1000000,3122616,3324070,2324070
1331,tt2547584,The Light Between Oceans,133.0,"Drama,Romance","Sep 2, 2016",20000000,12545979,22281732,2281732
1332,tt1544600,The Grace Card,101.0,Drama,"Feb 25, 2011",200000,2430735,2430735,2230735
1337,tt1549572,Another Earth,92.0,"Drama,Romance,Sci-Fi","Jul 22, 2011",175000,1321194,2102779,1927779
1339,tt1307068,Seeking a Friend for the End of the World,101.0,"Adventure,Comedy,Drama","Jun 22, 2012",10000000,7078738,11766959,1766959
1340,tt5124556,The Forsaken,86.0,"Drama,Horror,Thriller","Apr 27, 2001",5000000,6755271,6755271,1755271
1342,tt1869425,Filly Brown,80.0,"Drama,Music","Apr 19, 2013",1250000,2850357,2940411,1690411
1345,tt1669617,Home Run,82.0,"Drama,Family,Sport","Apr 19, 2013",1200000,2859955,2859955,1659955
1346,tt1216491,Kill the Messenger,112.0,"Biography,Crime,Drama","Oct 10, 2014",5000000,2450846,6656705,1656705
1348,tt0878835,Please Give,87.0,"Comedy,Drama","Apr 30, 2010",3000000,4033574,4570178,1570178
1349,tt1207922,Beyond the Mat,,"Drama,Sport","Oct 22, 1999",500000,2047570,2047570,1547570
1351,tt1745686,The Wall,108.0,"Drama,Fantasy,Mystery","May 12, 2017",3000000,1803064,4495262,1495262
1353,tt4183692,Woodlawn,123.0,"Drama,Sport","Oct 16, 2015",13000000,14394097,14403703,1403703
1355,tt2582500,Shut In,91.0,"Drama,Mystery,Thriller","Nov 11, 2016",10000000,6900335,11360665,1360665
1356,tt6476140,Serenity,106.0,"Drama,Mystery,Sci-Fi","Sep 30, 2005",39000000,25514517,40319440,1319440
1357,tt1694020,The Guilt Trip,95.0,"Comedy,Drama","Dec 19, 2012",40000000,37134215,41294674,1294674
1358,tt2582496,Me and Earl and the Dying Girl,105.0,"Comedy,Drama,Romance","Jun 12, 2015",8000000,6758416,9266180,1266180
1359,tt0935075,Rabbit Hole,91.0,Drama,"Dec 17, 2010",5000000,2229058,6205034,1205034
1360,tt7809816,Henry V,122.0,"Adventure,Biography,Drama","Nov 8, 1989",9000000,10161099,10176701,1176701
1363,tt1602098,Albert Nobbs,113.0,"Drama,Romance","Dec 21, 2011",7500000,3014696,8539003,1039003
